LAMEY	l ey m iy
LAMINER	l ae m ah n er
LAMMEY	l ae m iy
LAMONT	l ah m aa n t
LAMORTE	l aa m ao r t iy
LAMPKIN	l ae m p k ih n
LAMPP	l ae m p
LAMPTON	l ae m p t ah n
LAMSON	l ae m s ah n
LANAI	l ah n ay
LANCIA	l aa n ch ah
LANDERS	l ae n d er z
LANDI	l ae n d iy
LANDOLT	l ae n d ow l t
LANDRUM	l ae n d r ah m
LANDT	l ae n t
LANGBO	l ae ng b ow
LANGERS	l ae ng er z
LANGMAN	l ae ng m ah n
LANGUID	l ae ng g w ah d
LANIGAN	l ae n ih g ah n
LANNA	l ae n ah
LANNERS	l ae n er z
LANNI	l ae n iy
LANNING	l ae n ih ng
LANSKY	l ae n s k iy
LANTANA	l ae n t ae n ah
LANZA	l ae n z ah
LAPALME	l aa p aa l m iy
LAPIANA	l aa p iy ae n ah
LAPKA	l aa p k ah
LAPLACA	l ah p l aa k ah
LAPPE	l ae p
LAPPEN	l ae p ah n
LAPPING	l ae p ih ng
LAPSLEY	l ae p s l iy
LARCHE	l aa r ch iy
LARINA	l aa r iy n ah
LARIZZA	l er ih z ah
LARMORE	l aa r m ao r
LARNED	l aa r n d
LAROCHE	l aa r ow sh
LAROSE	l aa r ow s iy
LARSEN	l aa r s ah n
LARSH	l aa r sh
LASHED	l ae sh t
LASKI	l aa s k iy
LASKY	l ae s k iy
LASORSA	l aa s ao r s ah
LASS	l ae s
LAST	l ae s t
LAST'S	l ae s t s
LASTEST	l ae s t ah s t
LASZLO	l ae z l ow
LATA	l aa t ah
LATELLA	l aa t eh l ah
LATENT	l ey t ah n t
LATHAN	l ae th ah n
LATHE	l ey dh
LATHEM	l ae th ih m
LATHER	l ae dh er
LATIN	l ae t ah n
LATONA	l aa t ow n ah
LATRINE	l ah t r iy n
LATROBE	l aa t r ow b
LATSCH	l ae ch
LATSHAW	l ae ch ao
LAUFER	l ao f er
LAURDAN	l ao r d ah n
LAURENZ	l aw r ey n z
LAURI	l ao r iy
LAVE	l ey v
LAVER	l ey v er
LAVERY	l ey v er iy
LAVETTE	l ah v eh t
LAVI	l ey v iy
LAVINE	l aa v iy n iy
LAWHEAD	l ao hh eh d
LAWHON	l ao hh ah n
LAWHORN	l ae w er n
LAWLOR	l ao l er
LAWNS	l ao n z
LAWPLAN	l ao p l ae n
LAWSHE	l ao sh
LAX	l ae k s
LAY-UP	l ey ah p
LAYMEN	l ey m ah n
LAYOFFS	l ey ao f s
LAZAR	l ey z er
LAZARE	l aa z aa r ey
LAZEAR	l ah z ih r
LAZIER	l ey z iy er
LE	l ah
LEABO	l iy b ow
LEACH'S	l iy ch ih z
LEADOFF	l iy d ao f
LEAF	l iy f
LEAGUE	l iy g
LEAK	l iy k
LEANEST	l iy n ah s t
LEANN	l iy ae n
LEANZA	l iy ae n z ah
LEARN	l er n
LEATHER	l eh dh er
LEATON	l iy t ah n
LEBER	l iy b er
LEBO	l ey b ow
LEBOWE	l ih b ow
LECHNER	l eh k n er
LECLERC	l ah k l er k
LECOMTE	l ih k aa m t
LECOUNT	l ih k uw n t
LEDDEN	l eh d ah n
LEDONNE	l eh d ah n
LEDWITH	l eh d w ih th
LEEDS'S	l iy d z ih z
LEEN	l iy n
LEETH	l iy th
LEFEVRE	l ah f ey v er
LEFF	l eh f
LEFFLER	l eh f l er
LEFORT	l eh f er t
LEFTIST	l eh f t ih s t
LEGATO	l ah g aa t ow
LEGAULT	l ih g ow
LEGGITT	l eh g ih t
LEGION	l iy jh ah n
LEGLER	l eh g l er
LEH	l eh
LEHEW	l ey hh y uw
LEHL	l eh l
LEHNER	l eh n er
LEHRER	l eh r er
LEIFER	l ay f er
LEIKAM	l ay k ah m
LEILANI	l ah l aa n iy
LEIMAN	l ay m ah n
LEIMER	l ay m er
LEINER	l ay n er
LEISS	l ay s
LEIST	l iy ih s t
LEMBCKE	l eh m b k iy
LEMMER	l eh m er
LEMONT	l ah m aa n t
LENDING	l eh n d ih ng
LENDS	l eh n d z
LENE	l iy n
LENHART	l eh n hh aa r t
LENORE	l ah n ao r
LEONES	l iy ow n z
LEONORA	l iy ah n ao r ah
LEPER	l eh p er
LEPISTO	l eh p iy s t ow
LERNER	l er n er
LEROUX	l er uw
LES	l eh s
LESANE	l ey s aa n ey
LESHER	l eh sh er
LESIAK	l eh s iy ae k
LESS	l eh s
LESSON	l eh s ah n
LESSORS	l eh s er z
LET	l eh t
LETA	l eh t ah
LETO	l iy t ow
LETSON	l eh t s ah n
LETTICE	l eh t ih s
LEVANT	l ah v ae n t
LEVELED	l eh v ah l d
LEVIEN	l eh v iy ah n
LEVITCH	l eh v ih ch
LEVITY	l eh v ih t iy
LEVITZ	l eh v ih t s
LEW	l uw
LEWANNA	l uw ih n ah
LEYA	l ey ah
LEYH	l ey
LIANNE	l iy ae n
LIB	l ih b
LIBERAL	l ih b er ah l
LIBERTE	l ih b er t ey
LIBERTI	l iy b eh r t iy
LIBRARY	l ay b r eh r iy
LIBYA	l ih b iy ah
LICHENS	l ay k ah n z
LICITRA	l iy ch iy t r ah
LICKER	l ih k er
LIEBEL	l iy b ah l
LIEBLER	l iy b l er
LIFFE'S	l ih f s
LIFT	l ih f t
LIFTED	l ih f t ah d
LIGGETT	l ih g ih t
LIGHTS	l ay t s
LIKING	l ay k ih ng
LILIEN	l ih l iy ah n
LILIES	l ih l iy z
LILLIAN	l ih l iy ah n
LILY'S	l ih l iy z
LIMBERT	l ih m b er t
LIMES	l ay m z
LIMINE	l ih m ay n
LIMOGES	l ih m ow jh ih z
LIMPS	l ih m p s
LINAM	l ih n ah m
LINCK	l ih ng k
LINDELL	l ih n d ah l
LINDH	l ih n d
LINDMAN	l ih n d m ah n
LINDON	l ih n d ah n
LINEN	l ih n ah n
LINES'	l ay n z
LINETTE	l ih n eh t
LINGARD	l ih ng g er d
LINGERS	l ih ng g er z
LINGNER	l ih ng n er
LINH	l ih n
LINING	l ay n ih ng
LININGS	l ay n ih ng z
LINKS	l ih ng k s
LINKUP	l ih ng k ah p
LINNELL	l ih n ah l
LINOWES	l ih n ow z
LINSKY	l ih n s k iy
LION	l ay ah n
LIONIZE	l ay ah n ay z
LIPHAM	l ih f ah m
LIPMAN	l ih p m ah n
LIPSIG	l ih p s ih g
LIQUEFY	l ih k w ah f ay
LIRA	l ih r ah
LISBETH	l ih s b ih th
LISCO	l ih s k ow
LISH	l ih sh
LISSIE	l ih s iy
LISSY	l ih s iy
LIST'S	l ih s t s
LITA	l iy t ah
LITAN	l ay t ah n
LITANY	l ih t ah n iy
LITLE	l ay t ah l
LITWACK	l ih t w ao k
LIU	l y uw
LIVE	l ay v
LIVED	l ay v d
LIVESAY	l ih v ih s ey
LIVEZEY	l ih v ih z iy
LIVONIA	l ih v ow n y ah
LIZOTTE	l ih z ao t
LLERENA	l eh r ey n ah
LLOYD'S	l oy d z
LN	l ey n
LOADED	l ow d ah d
LOBAUGH	l aa b ao
LOBED	l ow b d
LOBES	l ow b z
LOBLAW	l aa b l ao
LOCALES	l ow k ae l z
LOCEY	l ow s iy
LOCKABY	l aa k ah b iy
LOCKLAR	l aa k l er
LOCKNER	l aa k n er
LOCKNEY	l aa k n ey
LOCTITE	l aa k t ay t
LOCUSTS	l ow k ah s t s
LODES	l ow d z
LOEB	l ow b
LOERA	l ao r ah
LOESCHE	l ow sh
LOGGIA	l aa g iy ah
LOGS	l ao g z
LOIN	l oy n
LOKER	l ow k er
LOLL	l aa l
LOMA	l ow m ah
LOMBA	l aa m b ah
LOMBARD	l aa m b aa r d
LONGLEG	l ao ng l eh g
LONGPRE	l aa ng p er
LOOKERS	l uh k er z
LOOKS	l uh k s
LOOMED	l uw m d
LOPPNOW	l aa p n aw
LOQUAT	l ow k w aa t
LORETTA	l er eh t ah
LOREY	l ao r iy
LORIMAR	l ao r ah m aa r
LORO	l ao r ow
LOSADA	l ow s aa d ah
LOTION	l ow sh ah n
LOTS	l aa t s
LOTUS	l ow t ah s
LOTZ	l aa t s
LOUANNE	l uw ae n
LOUDEST	l aw d ah s t
LOUDLY	l aw d l iy
LOUSED	l aw z d
LOUTS	l aw t s
LOUVIER	l aw v iy er
LOUVRE	l uw v r ah
LOVAAS	l aa v aa z
LOVAGE	l ah v ah jh
LOVEALL	l ah v ao l
LOVES	l ah v z
LOVITT	l aa v ih t
LOWBORN	l ow b ao r n
LOWELL	l ow ah l
LOYOLA	l oy ow l ah
LOZA	l ow z ah
LUAKA	l uw aa k ah
LUALLEN	l uw ae l ah n
LUANA	l uw ae n ah
LUBBEN	l ah b ah n
LUBER	l uw b er
LUCCO	l uw k ow
LUCENTE	l uw ch eh n t iy
LUCERO	l uw ch eh r ow
LUCEY	l uw s iy
LUCIAN	l uw sh ah n
LUCILE	l uw s iy l
LUCKY'S	l ah k iy z
LUDDEN	l ah d ah n
LUDDITE	l ah d ay t
LUDTKE	l ah d k iy
LUECKE	l uw k
LUEDERS	l uh d er z
LUFT	l ah f t
LUGARDA	l uw g aa r d ah
LUGER	l uw g er
LUGOSI	l uw g ow s iy
LUGS	l ah g z
LUI	l uw ih
LUICK	l uw k
LUIGI'S	l uw iy jh iy z
LUIKART	l uw k aa r t
LUKEN	l uw k ah n
LUKMAN	l ah k m ah n
LUKS	l ah k s
LULL	l ah l
LULLABY	l ah l ah b ay
LULLING	l ah l ih ng
LUMET	l uw m ah t
LUMPP	l ah m p
LUNATIC	l uw n ah t ih k
LUNCHED	l ah n ch t
LUNDEEN	l ah n d iy n
LUPICA	l uw p iy k ah
LUPUS	l uw p ah s
LURA	l uh r ah
LURCHES	l er ch ih z
LUSCHER	l ah sh er
LUSHER	l ah sh er
LUSHLY	l ah sh l iy
LUTMAN	l ah t m ah n
LUVS	l ah v z
LUXOR	l ah k s er
LYDON	l ih d ah n
LYFORD	l ih f er d
LYN	l ih n
LYNK	l ih ng k
LYTHGOE	l ih th g ow
M.	eh m
M.'S	eh m z
M1	eh m w ah n
M4	eh m f ao r
MAAG	m aa g
MAAM	m ah m
MAASSEN	m aa s ah n
MABEE	m ae b iy
MABEY	m ey b iy
MACAWS	m ah k ao z
MACBETH	m ah k b eh th
MACEDO	m ah s ey d ow
MACEWEN	m ah k y uw ah n
MACH	m aa k
MACHADO	m ah ch aa d ow
MACHE	m ae ch
MACHER	m ae k er
MACKALL	m ae k ah l
MACKIN	m ae k ih n
MACKLEM	m ae k l ah m
MACLEAN	m ah k l ey n
MACNAB	m ah k n ae b
MACRI	m ae k r iy
MAD	m ae d
MADCAP	m ae d k ae p
MADL	m ae d ah l
MADONIA	m aa d ow n iy ah
MADRY	m ae d r iy
MADY	m ey d iy
MADYUN	m ae d iy ah n
MAESTRO	m ay s t r ow
MAG	m ae g
MAGGARD	m ae g er d
MAGIE	m ey jh iy
MAGILL	m ae jh ah l
MAGNA	m ae g n ah
MAGNESS	m ah g n iy s
MAGNUS	m ae g n ah s
MAGOON	m ah g uw n
MAGPIES	m ae g p ay z
MAGWOOD	m ae g w uh d
MAHANEY	m ah hh ey n iy
MAHE	m ey hh iy
MAHLUM	m aa l ah m
MAHNKE	m ae ng k
MAHWAH	m aa w ah
MAIA	m ay ah
MAIDEN	m ey d ah n
MAIER	m ey er
MAIL'S	m ey l z
MAILMEN	m ey l m eh n
MAILS	m ey l z
MAIMING	m ey m ih ng
MAIREAD	m ey r eh
MAIS	m ey s
MAJCHER	m ae jh k er
MAKI	m aa k iy
MAKIN'	m ey k ih n
MAKING	m ey k ih ng
MAKITA	m ah k iy t ah
MAKOTO	m ah k ow t ow
MALACCA	m ah l ae k ah
MALAVE	m aa l aa v iy
MALAWI	m ah l aa w iy
MALCHOW	m aa l hh aw
MALCOLM	m ae l k ah m
MALERBA	m aa l eh r b ah
MALES	m ey l z
MALESKY	m ah l eh s k iy
MALICKI	m ah l ih k iy
MALINDA	m aa l iy n d ah
MALIS	m aa l iy z
MALLER	m ao l er
MALLOY	m ah l oy
MALLY	m ae l iy
MALONE	m ah l ow n
MALT	m ao l t
MALTS	m ao l t s
MALVERN	m ae l v er n
MAMBA	m aa m b ah
MAMBO	m aa m b ow
MAMIS	m ae m ih s
MAMSTED	m ae m s t eh d
MAMULA	m ae m y uw l ah
MANA	m aa n ah
MANAS	m aa n ah z
MANATEE	m ae n ah t iy
MANCINI	m aa n ch iy n iy
MANDERS	m ae n d er z
MANDICH	m ae n d ih k
MANELLA	m ah n eh l ah
MANER	m ey n er
MANG	m ae ng
MANGHAM	m ae ng g ah m
MANGINE	m aa ng g iy n iy
MANGINO	m aa ng g iy n ow
MANIAC	m ey n iy ae k
MANIACS	m ey n iy ae k s
MANIC	m ae n ih k
MANIGAT	m ae n ih g ae t
MANKER	m ae ng k er
MANNINA	m ae n ih n ah
MANNION	m ae n y ah n
MANSO	m ae n s ow
MANTA	m ae n t ah
MANTEY	m ae n t iy
MANU	m aa n uw
MANUAL	m ae n y uw ah l
MANZI'S	m ae n z iy z
MAORI	m aw r iy
MAPP	m ae p
MAQUILA	m ah k w iy l ah
MARACLE	m aa r ah k ah l
MARAFAT	m eh r ah f ae t
MARANTO	m er ae n t ow
MARASH'	m aa r ah sh
MARBACH	m aa r b aa k
MARCANO	m aa r k aa n ow
MARCHER	m aa r ch er
MARCI	m aa r s iy
MARCIAL	m aa r s iy aa l
MARCY	m aa r s iy
MARELLA	m er eh l ah
MARENO	m aa r eh n ow
MARES	m eh r z
MARESCO	m aa r eh s k ow
MARIA'S	m er iy ah z
MARIAN	m eh r iy ah n
MARIBEL	m ae r ih b eh l
MARING	m eh r ih ng
MARINOS	m er iy n ow z
MARJE	m aa r jh
MARKER	m aa r k er
MARKET	m aa r k ah t
MARKETS	m aa r k ah t s
MARKKAA	m aa r k aa
MARKUPS	m aa r k ah p s
MARKY	m aa r k iy
MARMION	m aa r m iy ah n
MARMON	m aa r m ah n
MARONI	m aa r ow n iy
MAROON	m er uw n
MAROSE	m er ow s
MAROTTE	m er ao t
MARRED	m aa r d
MARRIED	m eh r iy d
MARSAL	m aa r s ah l
MARSAM	m aa r s ae m
MARSCH	m aa r sh
MARSDEN	m aa r s d ah n
MARSICO	m aa r s iy k ow
MARSO	m aa r s ow
MART'S	m aa r t s
MARTINE	m aa r t iy n
MARTONE	m aa r t ow n iy
MARUI	m er uw iy
MARUKIN	m er uw k ih n
MARVIN	m aa r v ih n
MARWICK	m aa r w ih k
MARZAN	m aa r z ah n
MARZEC	m aa r z ih k
MASAMI	m aa s aa m iy
MASDEN	m ae s d ah n
MASIN	m aa s ih n
MASINO	m aa s iy n ow
MASIUS	m ae s iy ah s
MASKER	m ae s k er
MASON'S	m ey s ah n z
MASSIEU	m ae s iy uw
MASSIVE	m ae s ih v
MATER	m aa t er
MATERN	m ae t er n
MATES	m ey t s
MATHIS	m ae th ih s
MATHWIG	m ae th w ih g
MATISSE	m ae t iy s
MATLACK	m ae t l ae k
MATSAPA	m ae t s aa p ah
MATTEO	m aa t ey ow
MATTHIS	m ae th ih s
MATTHYS	m ae th iy z
MATTIE	m ae t iy
MATTIS	m ae t ih s
MATTKE	m ae t k iy
MATTOS	m ae t ow z
MATULA	m aa t uw l ah
MATZOH	m ae t s ah
MAUDLIN	m ao d l ih n
MAUMEE	m aw m iy
MAURIN	m ao r ih n
MAURITZ	m ao r ih t s
MAURO	m ao r ow
MAUS	m ao z
MAUTZ	m ao t s
MAVIS	m ey v ih s
MAWR	m ao er
MAXIMAL	m ae k s ah m ah l
MAXXIM	m ae k s ih m
MAY	m ey
MAYA	m ay ah
MAYDENA	m ey d ih n ah
MAYLE	m ey l
MAYNARD	m ey n er d
MAYNE	m ey n
MAZOLA	m ah z ow l ah
MCADOO	m ae k ah d uw
MCAMIS	m ah k ae m ah s
MCBREEN	m ah k b r iy n
MCCAGUE	m ah k ey g
MCCAIG	m ah k ey g
MCCAMY	m ah k ey m iy
MCCANE	m ah k ey n
MCCAW	m ah k ao
MCCLAIN	m ah k l ey n
MCCLEAN	m ah k l iy n
MCCOOL	m ah k uw l
MCCOWEN	m ah k aw ah n
MCCOY	m ah k oy
MCCOYS	m ah k oy z
MCCRAE	m ah k r ey
MCDARIS	m ah k d ae r ah s
MCDAVID	m ah k d ey v ah d
MCDUFF	m ah k d ah f
MCELROY	m ae k ah l r oy
MCENANY	m ae k ah n ey n iy
MCENERY	m ah k eh n er iy
MCEVER	m ah k eh v er
MCGAHAN	m ah g ae hh ah n
MCGARY	m ah g eh r iy
MCGAVIN	m ah g ae v ah n
MCGLORY	m ah g l ao r iy
MCGLYNN	m ah g l ih n
MCGOFF	m ah g ao f
MCGOWAN	m ah g aw ah n
MCGOWN	m ah g aw n
MCGRAIN	m ah g r ey n
MCGRATH	m ah g r ae th
MCGREW	m ah g r uw
MCGUIRE	m ah g w ay r
MCKAY	m ah k ey
MCKENNA	m ah k eh n ah
MCKNEW	m ah k n uw
MCKREE	m ah k r iy
MCKUNE	m ah k y uw n
MCMAHAN	m ah k m ey hh ah n
MCMORAN	m ah k m ao r ah n
MCNAIR	m ah k n eh r
MCNAIRY	m ah k n eh r iy
MCNEIL	m ah k n iy l
MCNEILL	m ah k n iy l
MCQUAID	m ah k w ey d
MCQUOWN	m ah k w aw n
MCRIGHT	m ah k r ay t
MCROY	m ah k r oy
MCTAGUE	m ah k t ey g
MCVEY	m ah k v ey
MEAD	m iy d
MEADORS	m iy d er z
MEALOR	m iy l er
MEASLES	m iy z ah l z
MEAT	m iy t
MEATS	m iy t s
MEAVE	m iy v
MECKLER	m eh k l er
MEDFACT	m eh d f ae k t
MEDFLY	m eh d f l iy
MEDICAL	m eh d ah k ah l
MEDICO	m eh d ih k ow
MEDIUM	m iy d iy ah m
MEDLEN	m eh d l ah n
MEDUSAS	m ah d uw s ah z
MEEKLY	m iy k l iy
MEESE	m iy s
MEG	m eh g
MEGEE	m eh jh iy
MEGNA	m eh g n ah
MEHMET	m eh m ah t
MEI	m ey
MEINCKE	m ay ng k iy
MEISEL	m ay s ah l
MEL'S	m eh l z
MELANIE	m eh l ah n iy
MELE	m iy l
MELESKI	m ih l eh s k iy
MELICAN	m eh l ih k ah n
MELL	m eh l
MELONE	m eh l ow n iy
MELROSE	m eh l r ow z
MELTON	m eh l t ah n
MELVINA	m eh l v iy n ah
MEMEL	m eh m ah l
MEMMER	m eh m er
MEMOLI	m eh m ow l iy
MENARD	m ih n aa r d
MENATEP	m eh n ah t eh p
MENDOLA	m eh n d ow l ah
MENKA	m eh ng k ah
MENTHOL	m eh n th ao l
MERCADO	m er k aa d ow
MERDYCE	m er d ay s
MERGE	m er jh
MERHIGE	m er hh iy jh
MERKER	m er k er
MERLINA	m er l iy n ah
MERLINO	m er l iy n ow
MERRELL	m eh r ah l
MERRETT	m eh r ih t
MERRIER	m eh r iy er
MERTA	m eh r t ah
MERTICE	m eh r t ih s
MERTZ	m er t s
MESABA	m eh s aa b ah
MESBICS	m eh s b ih k s
MESH	m eh sh
MESHELL	m eh sh ah l
MESMER	m eh z m er
MESTRE	m eh s t er
METALS'	m eh t ah l z
METPATH	m eh t p ae th
METRE	m iy t er
METRIC	m eh t r ih k
METTE	m eh t
METTER	m eh t er
METZGER	m eh t s g er
MEUSER	m oy s er
MEWAS	m y uw ah s
MEYN	m ey n
MHOON	m hh uw n
MIARA	m ay aa r ah
MIAZGA	m iy aa z g ah
MICHELL	m ih ch ah l
MICHIO	m ih ch iy ow
MICHNA	m ih ch n ah
MICKY	m ih k iy
MICOIN	m ih k oy n
MIDAIR	m ih d eh r
MIDST	m ih d s t
MIDWIFE	m ih d w ay f
MIENO	m iy n ow
MIERS	m ay er z
MIERZWA	m iy r z w ah
MIESSE	m iy s
MIGGINS	m ih g ih n z
MIGLIN	m ih g l ih n
MIGRANT	m ay g r ah n t
MIGRATE	m ay g r ey t
MIGUES	m iy g eh s
MIHALEK	m ih hh ah l eh k
MIHALIC	m ih hh ae l ih k
MIHM	m ih m
MIKAL	m iy k ah l
MIKLOS	m iy k l ow s
MIKOS	m ay k ow z
MIKULEC	m ih k uw l ih k
MILAN'S	m ih l aa n z
MILAZZO	m iy l aa z ow
MILCH	m ih l ch
MILEM	m ih l ah m
MILHOAN	m ih l hh ow n
MILITO	m iy l iy t ow
MILK	m ih l k
MILLET	m ih l ah t
MILLIET	m ih l iy eh t
MILLSAP	m ih l s ae p
MILODIC	m ih l ow d ih k
MILTIE	m ih t iy
MILZ	m ih l z
MIM	m ih m
MIME	m ay m
MIMICRY	m ih m ih k r iy
MIMIS	m iy m iy z
MIMS	m ih m z
MINARET	m ih n er eh t
MINCER	m ih n s er
MINCES	m ih n s ih z
MINCY	m ih n s iy
MIND	m ay n d
MINDING	m ay n d ih ng
MINDS	m ay n d z
MINDY	m ih n d iy
MINEHAN	m ih n ih hh ae n
MINELLI	m ih n eh l iy
MINGLED	m ih ng g ah l d
MINH	m ih n
MINI	m ih n iy
MINIMUM	m ih n ah m ah m
MINIS	m ih n iy z
MINKOFF	m ih ng k ao f
MINKS	m ih ng k s
MINNEY	m ih n iy
MINNIX	m ih n ih k s
MINORED	m ay n er d
MINOTTI	m ih n ao t iy
MINSKY	m ih n s k iy
MINSTAR	m ih n s t aa r
MINYARD	m ih n y aa r d
MIOTKE	m ay aa t k iy
MIRAGE	m er aa zh
MIRELL	m ih r eh l
MIRIAM	m ih r iy ah m
MIRSAD	m ih r s ae d
MIRTH	m er th
MISHOE	m iy sh uw
MISKA	m ih s k ah
MISKO	m ih s k ow
MISNER	m ih z n er
MISSAL	m ih s ah l
MISSEY	m ih s iy
MISSILE	m ih s ah l
MISTS	m ih s t s
MITA	m iy t ah
MIXED	m ih k s t
MIXES	m ih k s ah z
MIZELLE	m ih z eh l
MIZUNO	m ih z uw n ow
MIZZELL	m ih z ah l
MLADIC	m l aa d ih ch
MOAB	m ow ae b
MOAN	m ow n
MOATES	m ow ey t s
MOBBS	m aa b z
MOBIL'S	m ow b ah l z
MOBLEY	m ow b l iy
MOBS	m aa b z
MODIFY	m aa d ah f ay
MOE	m ow
MOEHLE	m ow hh ah l
MOEN	m ow n
MOENCH	m ow ng k
MOERKE	m ao r k
MOERS	m ow er z
MOFFA	m aa f ah
MOGER	m ow g er
MOGLE	m ow g ah l
MOIST	m oy s t
MOKES	m ow k s
MOL	m ao l
MOLDEN	m ow l d ah n
MOLE	m ow l
MOLIN	m ow l ih n
MOLINA	m ah l iy n ah
MOLLIE	m aa l iy
MOLLO	m aa l ow
MOLLUSK	m aa l ah s k
MOLLY'S	m aa l iy z
MOLOCK	m aa l ah k
MOLTING	m ow l t ih ng
MOLZAHN	m ow l z ah n
MON	m ow n
MONAD	m ow n ae d
MONDAY	m ah n d iy
MONDRY	m aa n d r iy
MONGER	m ah ng g er
MONGERS	m ah ng g er z
MONGOL	m aa ng g ah l
MONK	m ah ng k
MONNIER	m aa n iy er
MONSOON	m aa n s uw n
MONTAGU	m aa n t ah g y uw
MONTERO	m aa n t eh r ow
MONTEZ	m ow n t eh z
MONTS	m aa n t s
MONTY	m ao n t iy
MONTZ	m aa n t s
MONY	m ow n iy
MOO	m uw
MOODY	m uw d iy
MOONE	m uw n
MOONS	m uw n z
MOOR	m uh r
MOP	m aa p
MOQUIN	m ow k w iy n
MORAGA	m ao r aa g ah
MORAIN	m er ey n
MORAND	m ao r ah n d
MORANTE	m ao r aa n t iy
MORASH	m ao r ah sh
MORAY	m er ey
MOREEN	m ao r iy n
MORES	m ao r ey z
MORETON	m ao r ih t aa n
MORETTO	m ao r eh t ow
MORETZ	m ao r ih t s
MORIAL	m ao r iy ah l
MORINI	m ao r iy n iy
MORIOKA	m ao r iy ow k ah
MORIYA	m ao r iy ah
MORNING	m ao r n ih ng
MOROCCO	m er aa k ow
MOROS	m ao r ow z
MORPHIS	m ao r f ih s
MORR	m ao r
MORRIN	m ao r ih n
MORRONE	m ao r ow n iy
MORRY	m ao r iy
MORSCH	m ao r sh
MOSAICS	m ow z ey ih k s
MOSER	m ow z er
MOSHER	m ow zh er
MOSHIER	m aa sh iy er
MOSK	m ao s k
MOSKWA	m aa s k v ah
MOSTOW	m aa s t aw
MOSUL	m ow s ah l
MOTE	m ow t
MOTTERN	m aa t er n
MOTTO	m aa t ow
MOTZKO	m aa t s k ow
MOULDER	m ow l d er
MOURAD	m uw r ae d
MOUW	m aw w
MOVABLE	m uw v ah b ah l
MOVED	m uw v d
MOVERS	m uw v er z
MOWAT	m ow ah t
MOWATT	m ow ah t
MOWBRAY	m ow b r ey
MOWERY	m aw er iy
MOWS	m aw z
MRAZ	m r ae z
MRAZIK	m r aa z ih k
MROCZEK	m r aa ch eh k
MROZ	m r aa z
MRS	m ih s ih z
MSGR	m aa n s iy n y er
MU	m uw
MUCCIO	m uw ch iy ow
MUCUS	m y uw k ah s
MUFFINS	m ah f ah n z
MUFFY	m ah f iy
MUGAR	m y uw g er
MUGGED	m ah g d
MUKLUK	m ah k l ah k
MULLER	m ah l er
MULLOY	m ah l oy
MULNIX	m ah l n ih k s
MUMBLES	m ah m b ah l z
MUMBY	m ah m b iy
MUMFORD	m ah m f er d
MUMMY	m ah m iy
MUMPER	m ah m p er
MUN	m ah n
MUNCHED	m ah n ch t
MUNCIE	m ah n s iy
MUNKRES	m ah ng k er z
MUNRO	m ah n r ow
MURAI	m y er ay
MURALI	m er aa l iy
MURCHIE	m er ch iy
MURDOCH	m er d aa k
MURIEL	m y uh r iy ah l
MURILLO	m ah r ih l ow
MURRILL	m ao r ah l
MURVEIT	m er v iy t
MUSEUM	m y uw z iy ah m
MUSHTAQ	m ah sh t ae k
MUSIAL	m y uw z iy ah l
MUSICA	m y uw z ih k ah
MUSKY	m ah s k iy
MUSSO	m uw s ow
MUST	m ah s t
MUSTER	m ah s t er
MUZYKA	m y uw z ih k ah
MY	m ay
MYANMAR	m y aa n m aa r
MYELIN	m ay ih l ih n
MYERS'S	m ay er z ih z
MYETTE	m ay eh t
MYHRE	m ih r
MYREON	m ay r iy ah n
MYRICK	m ay r ih k
MYRLIE	m ih r l iy
MYRTLES	m er t ah l z
MYSTIFY	m ih s t ah f ay
N-TUPLE	eh n t uw p ah l
NABER	n ey b er
NABERS	n ey b er z
NABOB	n ae b aa b
NABOZNY	n ah b aa z n iy
NADER	n ey d er
NADINE	n ah d iy n
NAGATA	n aa g aa t ah
NAGER	n ey g er
NAGGING	n ae g ih ng
NAHMIAS	n aa m iy ah z
NAILS	n ey l z
NAIM	n ay ih m
NAKAI	n aa k aa iy
NAKATA	n aa k aa t ah
NALE	n ey l
NAME'S	n ey m z
NAMING	n ey m ih ng
NANA	n ae n ah
NANDITA	n aa n d iy t ah
NANETTE	n ah n eh t
NANEZ	n aa n eh z
NANKING	n ae ng k ih ng
NAPCO	n ae p k ow
NAPKIN	n ae p k ih n
NAPPING	n ae p ih ng
NARCOS	n aa r k ow s
NARITA	n eh r iy t ah
NARROW	n eh r ow
NARS	n aa r z
NARVAEZ	n aa r v aa eh z
NASBY	n ae s b iy
NASH'S	n ae sh ih z
NATAL	n ey t ah l
NATAN	n ey t ah n
NATHENE	n ah th iy n
NATIONS	n ey sh ah n z
NATIVE	n ey t ih v
NATOLI	n aa t ow l iy
NATS	n ae t s
NATSIOS	n ae t s iy ow s
NATUNA	n ah t uw n ah
NATURED	n ey ch er d
NATZKE	n ae t s k iy
NAV	n ae v
NAVAL	n ey v ah l
NAVCOM	n ae v k aa m
NAWROT	n ao r ah t
NAYS	n ey z
NAZI	n aa t s iy
NEATEST	n iy t ah s t
NEAULT	n ow
NEBLETT	n eh b l ih t
NECKS	n eh k s
NECO'S	n iy k ow z
NEDEL	n iy d ah l
NEGRI	n eh g r iy
NEGRIN	n eh g r ih n
NEICE	n iy s
NEIL	n iy l
NEISLER	n ay s ah l er
NELIA	n eh l iy ah
NELLCOR	n eh l k ao r
NELSON	n eh l s ah n
NEMO	n eh m ow
NEMOS	n iy m ow z
NENI'S	n eh n iy s
NEONAZI	n iy ow n aa t s iy
NEPA	n iy p ah
NERLICH	n er l ih k
NERVANA	n er v ae n ah
NESBITT	n eh z b ih t
NESI	n eh s iy
NESSLER	n eh s l er
NESTEA	n eh s t iy ah
NEUTRON	n uw t r aa n
NEVEAU	n ih v ow
NEVERS	n eh v er z
NEVES	n iy v z
NEVEU	n ih v uw
NEVIN'S	n eh v ih n z
NEWARK	n uw er k
NEWBERY	n uw b eh r iy
NEWHART	n uw hh aa r t
NEWLON	n uw l ah n
NEWLYN	n uw l ih n
NEWSHAM	n uw sh ah m
NEXT'S	n eh k s t s
NEYER	n ey er
NEYHART	n ey hh aa r t
NEYLON	n ey l ah n
NGUYEN	n uw y eh n
NI	n iy
NIBBLED	n ih b ah l d
NIBLACK	n ih b l ae k
NICEN	n ay s ah n
NICHOL	n ih k ao l
NICKENS	n ih k ah n z
NICKI	n ih k iy
NICKLOW	n ih k l ow
NICKOL	n ih k ah l
NICKOLS	n ih k ah l z
NICKS	n ih k s
NICOLAY	n ih k ah l ey
NICOSKI	n ih k ao s k iy
NIEMIEC	n iy m iy k
NIENOW	n iy n ow
NIESEN	n iy s ah n
NIGGARD	n ih g er d
NIGRIS	n ih g r ih s
NIKE'S	n ay k iy z
NIKOLAI	n ih k ow l ay
NILSSON	n ih l s ah n
NIMMER	n ih m er
NINA	n iy n ah
NINAD	n ay n ah d
NINE	n ay n
NINERS	n ay n er z
NINNY	n ih n iy
NIPON	n ih p aa n
NIPPER	n ih p er
NIPPLE	n ih p ah l
NISHIMO	n ih sh iy m ow
NISLEY	n ih z l iy
NISSANS	n iy s aa n z
NISSIN	n ih s ih n
NITA	n iy t ah
NITPICK	n ih t p ih k
NITRATE	n ay t r ey t
NITSCH	n ih ch
NITTO	n ih t ow
NIVER	n ay v er
NIXES	n ih k s ih z
NIXON	n ih k s ah n
NIZAR	n ay z aa r
NIZHNY	n ih zh n iy
NOBIS	n ow b ih s
NOBLITT	n aa b l ih t
NOBRIGA	n aa b r ih g ah
NOBUTO	n ow b uw t ow
NODINE	n ow d iy n iy
NOELL	n ow l
NOGLE	n ow g ah l
NOGUERA	n ow g eh r ah
NOLA	n ow l ah
NOLD	n ow l d
NOLDEN	n ow l d ah n
NOLLIE	n ow l iy
NOMAD	n ow m ae d
NOMI	n ow m iy
NONJET	n aa n jh eh t
NORAH	n ao r ah
NORBURY	n ao r b eh r iy
NORDELL	n ao r d ah l
NORDEN	n ao r d ah n
NORDINE	n ao r d iy n iy
NORDISK	n ao r d ih s k
NORED	n ao r d
NOREM	n ao r ih m
NOREN	n ao r ah n
NORRIS	n ao r ih s
NORTH	n ao r th
NORWARD	n ao r w er d
NORWEB	n ao r w eh b
NOSEK	n ow s eh k
NOTCHES	n aa ch ah z
NOTICES	n ow t ah s ah z
NOTIONS	n ow sh ah n z
NOVA'S	n ow v ah z
NOVACEK	n aa v ah ch eh k
NOVACOR	n ow v ah k ao r
NOWADAY	n aw ah d ey
NOWHERE	n ow w eh r
NOWLIN	n aw l ih n
NOXELL	n aa k s eh l
NOXEMA	n aa k s iy m ah
NOXON	n aa k s ah n
NOYD	n oy d
NOYOLA	n oy ow l ah
NUALA	n uw aa l ah
NUBER	n uw b er
NUDO	n uw d ow
NULL	n ah l
NUMBED	n ah m d
NUNZIO	n ah n z iy ow
NUOVO	n w ow v ow
NURSED	n er s t
NURSES	n er s ah z
NUSZ	n ah sh
NUTLEY	n ah t l iy
NUZZI	n uw t s iy
NUZZLE	n ah z ah l
NUZZO	n uw z ow
NVHOME	eh n v iy hh ow m
NYCOR	n ay k ao r
NYCZ	n ih ch
NYLUND	n ay l ah n d
NYMEX	n ay m eh k s
NYMPHS	n ih m f s
NYX	n ih k s
O'BRIEN	ow b r ay ih n
O'BRYAN	ow b r ay ah n
O'HERN	ow hh er n
O'KICKI	ow k ih k iy
O'LEAR	ow l ih r
O'NUTS	ow n ah t s
O'S	ow z
O'SHEA	ow sh ey
OAK'S	ow k s
OAKS	ow k s
OAKWOOD	ow k w uh d
OARED	ao r d
OATES	ow t s
OBAMA	ow b aa m ah
OBARR	ow b aa r
OBEIRNE	ow b er r n
OBESE	ow b iy s
OBEYING	ow b ey ih ng
OBISPO	ow b ih s p ow
OBOE	ow b ow
OBRYAN	ow b r ay ah n
OBSCURE	ah b s k y uh r
OBSESS	ah b s eh s
OCCUR	ah k er
OCTAVES	aa k t ih v z
OCTAVIA	aa k t ey v iy ah
ODANIEL	aa d ah n iy l
ODDER	aa d er
ODDI	aa d iy
ODE	ow d
ODER	ow d er
ODLE	ow d ah l
ODOLF	ah d ow l f
OEDIPAL	eh d ah p ah l
OEHLER	ow l er
OEHLKE	ow l k
OEHMEN	ow m ah n
OEST	ow ih s t
OFELIA	ow f ey l iy ah
OFFER	ao f er
OFFIELD	aa f iy l d
OFFS	ao f s
OFFSET	ao f s eh t
OFTEL	aa f t eh l
OGATA	ow g aa t ah
OGG	aa g
OHAIR	ow hh eh r
OHANLON	ow hh ae n l ah n
OHARA	ow hh eh r ah
OHARRA	ow hh er ah
OHERN	ow hh er n
OHIO'S	ow hh ay ow z
OHLMANN	ow l m ah n
OHLSSON	ow l s ah n
OHMURA	ow m uw r ah
OHR	ao r
OI	oy
OIL'S	oy l z
OKANE	ow k ey n
OKAZ	ow k aa z
OKEEFE	ow k iy f
OKELLEY	ow k eh l iy
OKELLY	ow k eh l iy
OKIN	ow k ih n
OKSANA	aa k s ae n ah
OLDE	ow l d
OLDER	ow l d er
OLDROYD	ow l d r oy d
OLDSMAR	ow l d z m aa r
OLDSTER	ow l d s t er
OLEA	aa l iy ah
OLEJNIK	ah l ey n ih k
OLENIK	aa l ih n ih k
OLICK	ow l ih k
OLIVIER	ow l ih v iy ey
OLLIE'S	aa l iy z
OLOF	ow l ao f
OLSTAD	ow l s t ah d
OMARY	ah m eh r iy
OMELETS	aa m l ah t s
OMER	ow m er
OMRON	aa m r ah n
ONDER	aa n d er
ONE-WAY	w ah n w ey
ONECOMM	w ah n k aa m
ONEIDA	ow n ay d ah
ONEX'S	w ah n eh k s ih z
ONION	ah n y ah n
ONLINE	ao n l ay n
ONLY	ow n l iy
ONNI	aa n iy
ONSET	aa n s eh t
OODLES	uw d ah l z
OOH	uw
OONA	uw n ah
OP	aa p
OPDYKE	aa p d ay k
OPERAN	aa p er ah n
OPHELIA	ah f iy l y ah
OPIC'S	aa p ih k s
OPIE	ow p iy
OPIELA	ow p iy l ah
OPINED	ow p ay n d
OPS	aa p s
ORBACH	ao r b aa k
ORBEN	ao r b ah n
ORBIT	ao r b ah t
ORCA	ao r k ah
ORCHIDS	ao r k ah d z
OREFICE	ao r eh f ay s
OREGANO	ao r eh g ah n ow
ORENS	ao r ah n z
ORG	ao r g
ORGAN	ao r g ah n
ORGANIC	ao r g ae n ih k
ORGANUM	ao r g ah n ah m
ORI	ao r iy
ORILEY	ow r ay l iy
ORKY	ao r k iy
ORLANDI	ao r l aa n d iy
ORLANDO	ao r l ae n d ow
ORLENE	ao r l iy n
ORMAN	ao r m ah n
ORMAND	ao r m ah n d
ORNOFF	ao r n aa f
ORONA	ao r ow n ah
ORPHEUS	ao r f iy ah s
ORRICO	ao r iy k ow
ORSBORN	ao r s b er n
ORSO	ao r s ow
ORT	ao r t
ORTEGO	ao r t ey g ow
ORTH	ao r th
ORTNER	ao r t n er
ORVAL	ao r v ah l
ORYX	ao r ih k s
OS	aa s
OSAGES	ow s ey jh ah z
OSAKOWA	ow s ah k ow ah
OSBORN	ao z b ao r n
OSHA'S	ow sh ah z
OSHIMA	ow sh iy m ah
OSKAR	ao s k er
OSLIN	aa s l ih n
OSMAR	aa s m er
OSMONDS	ao z m ah n d z
OSMUND	aa s m ah n d
OSRIC	aa z r ih k
OSSMAN	aa s m ah n
OSTLUND	aa s t l ah n d
OSUNA	ow s uw n ah
OTA	ow t ah
OTHERS'	ah dh er z
OTOOLE	aa t uw l
OTTER	aa t er
OTTER'S	aa t er z
OTTLEY	aa t l iy
OTULSKY	ah t uh l s k iy
OUNCE	aw n s
OUNSTED	aw n s t eh d
OUR	aw er
OUSTER	aw s t er
OUTDATE	aw t d ey t
OUTER	aw t er
OUTFOX	aw t f aa k s
OUTING	aw t ih ng
OUTLAWS	aw t l ao z
OUTLETS	aw t l eh t s
OUTMODE	aw t m ow d
OUTRUNS	aw t r ah n z
OUTSIDE	aw t s ay d
OVARY	ow v er iy
OVATE	ow v ey t
OVATION	ow v ey sh ah n
OVERACT	ow v er ae k t
OVEREAT	ow v er iy t
OVERSEA	ow v er s iy
OVETT'S	ow v eh t s
OVITT'S	ow v ih t s
OWENS'S	ow ah n z ih z
OWOSSO	ow ao s ow
OXCART	aa k s k aa r t
OXEN	aa k s ah n
OXFORD	aa k s f er d
OXOCO	aa k s ow k ow
OXYGEN	aa k s ah jh ah n
OZAL	ow z ah l
PAASCH	p aa sh
PACCAR	p ah k aa r
PACIFY	p ae s ah f ay
PACKARD	p ae k er d
PACTEL	p ae k t eh l
PACYNA	p aa k iy n ah
PAD	p ae d
PADDED	p ae d ah d
PADDOCK	p ae d ah k
PAGAN	p ey g ah n
PAGANI	p aa g aa n iy
PAGAR	p ae g er
PAGEL	p ae g ah l
PAGES	p ey jh ah z
PAGET	p ae jh ah t
PAGEZY	p ae jh eh z iy
PAINT	p ey n t
PAIRING	p eh r ih ng
PAJOLE	p ah jh ow l
PAKULA	p ah k uw l ah
PAL	p ae l
PALARDY	p ah l aa r d iy
PALATE	p ae l ah t
PALATES	p ae l ah t s
PALLER	p ae l er
PALLETT	p ae l ah t
PALMA'S	p aa l m ah z
PALMORE	p ae l m ao r
PALOMAR	p ae l ah m aa r
PALOMBI	p ah l aa m b iy
PALS	p ae l z
PALUCK	p ae l ah k
PAM	p ae m
PAM'S	p ae m z
PAMBY	p ae m b iy
PAMPAS	p ae m p ah z
PAMPER	p ae m p er
PANACHE	p ah n aa sh
PANAMA	p ae n ah m aa
PANAS	p ae n ah z
PANCHO	p ae n ch ow
PANDER	p ae n d er
PANEM	p ey n ah m
PANG	p ae ng
PANGS	p ae ng z
PANKEY	p ae n k iy
PANTER	p ae n t er
PANTOJA	p aa n t ow y ah
PAPPAS	p ae p ah s
PAPPERT	p ae p er t
PAQUE	p ae k
PAQUIN	p ae k w ih n
PARA	p eh r ah
PARADES	p er ey d z
PARANA	p er aa n ah
PARAZOA	p eh r ah z ow ah
PARBOIL	p aa r b oy l
PARCHED	p aa r ch t
PARDEE	p aa r d iy
PARDUE	p aa r d uw
PAREDO	p ah r ey d ow
PARETI	p eh r eh t iy
PARGESA	p aa r jh eh s ah
PARIAHS	p er ay ah z
PARIBAS	p eh r iy b ah s
PARKER	p aa r k er
PARKEY	p aa r k iy
PARLOUR	p aa r l er
PARLOW	p aa r l ow
PARMLEY	p aa r m l iy
PARNESS	p aa r n ah s
PARROTS	p eh r ah t s
PARSEC	p aa r s eh k
PARSLEY	p aa r s l iy
PART	p aa r t
PARTAIN	p aa r t ey n
PASLAY	p ae s l ey
PASSED	p ae s t
PASSERS	p ae s er z
PASTA	p aa s t ah
PASTELS	p ae s t eh l z
PASTING	p ey s t ih ng
PASTULA	p aa s t uw l ah
PAT	p ae t
PATAKI	p ah t aa k iy
PATEL	p ah t eh l
PATERNO	p aa t eh r n ow
PATIENT	p ey sh ah n t
PATS	p ae t s
PATTER	p ae t er
PATZKE	p ae t s k iy
PAULK	p ao l k
PAUP	p ao p
PAUSED	p ao z d
PAVES	p ey v z
PAVESE	p aa v ey z iy
PAVLIK	p ae v l ih k
PAVO	p aa v ow
PAWLAK	p ao l ah k
PAWNS	p ao n z
PAWSON	p ao s ah n
PAYCHEX	p ey ch eh k s
PAYLOR	p ey l er
PAYMENT	p ey m ah n t
PAYOFFS	p ey ao f s
PAYOLA	p ey ow l ah
PAZNER	p aa z n er
PEACE	p iy s
PEACHER	p iy ch er
PEAKES'	p iy k s
PEARCY	p er k iy
PEARY	p iy r iy
PEAVEY	p iy v iy
PECHORA	p ah k ao r ah
PECHT	p eh k t
PEDALS	p eh d ah l z
PEDDIE	p eh d iy
PEDDLER	p eh d l er
PEDDLES	p eh d ah l z
PEELER	p iy l er
PEEPLES	p iy p ah l z
PEERED	p ih r d
PEETE	p iy t
PEEVE	p iy v
PEEVISH	p iy v ih sh
PEINADO	p ey iy n aa d ow
PEIPU	p ey p uw
PEKO	p iy k ow
PELE	p eh l ey
PELICAN	p eh l ah k ah n
PELKA	p eh l k ah
PELOSI	p eh l ow s iy
PELT	p eh l t
PELTON	p eh l t ah n
PELTZ	p eh l t s
PELUSO	p eh l uw s ow
PELVIC	p eh l v ih k
PEMEX	p eh m eh k s
PENA	p eh n ah
PENFOLD	p eh n f ow l d
PENNIE	p eh n iy
PENNY	p eh n iy
PENROD	p eh n r aa d
PENS	p eh n z
PENTIUM	p eh n t iy ah m
PENTZ	p eh n t s
PENWELL	p eh n w eh l
PENZER	p eh n z er
PEONS	p iy ah n z
PEPCID	p eh p s ih d
PEPSI	p eh p s iy
PEPSICO	p eh p s ih k ow
PEPTIC	p eh p t ih k
PERA	p er ah
PERCEPT	p er s eh p t
PERCH	p er ch
PERDEW	p er d uw
PERES'S	p eh r eh z ih z
PERETZ	p er ih t s
PERHAPS	p er hh ae p s
PERIGO	p er iy g ow
PERJURE	p er jh er
PERL	p er l
PERLOW	p er l ow
PERMUT	p er m ah t
PERNO	p er n ow
PEROT'S	p er ow z
PERPLEX	p er p l eh k s
PERRELL	p er r ey l
PERRIGO	p er r iy g ow
PERRON	p eh r ah n
PERSIAN	p er zh ah n
PERTURB	p er t er b
PESCHKE	p eh sh k
PESNELL	p ih s n eh l
PESO'S	p ey s ow z
PETE'S	p iy t s
PETER'S	p iy t er z
PETERY	p iy t er iy
PETEY	p iy t iy
PETIT	p eh t iy
PETRI	p eh t r iy
PETRU	p eh t r uw
PETRY	p eh t r iy
PETTING	p eh t ih ng
PEYTON	p ey t ah n
PFAFF	f ae f
PFARR	f aa r
PFEIFLE	f ay f ah l
PFLUGER	f l uw g er
PH	p iy ey ch
PHARISS	f er ih s
PHEBE	f iy b iy
PHILIPS	f ih l ah p s
PHLEGM	f l eh m
PHOBOS	f ow b ow s
PHOEBUS	f iy b ah s
PHONIC	f aa n ih k
PHUT	f ah t
PHYLLIS	f ih l ih s
PIC	p ih k
PICHENY	p ah ch eh n iy
PICKER	p ih k er
PICKING	p ih k ih ng
PICKLER	p ih k ah l er
PICKUS	p ih k ah s
PICTON	p ih k t ah n
PIDDOCK	p ih d ah k
PIELA	p iy l ah
PIERO	p iy r ow
PIERRE	p iy eh r
PIERRO	p ih r ow
PIERSOL	p ih r s ao l
PIET	p ay ih t
PIETER	p iy t er
PIETTE	p iy t
PIGFORD	p ih g f er d
PILANT	p iy l ah n t
PILATUS	p iy l ey t ah s
PILED	p ay l d
PILEUP	p ay l ah p
PILGER	p ih l g er
PILINGS	p ay l ih ng z
PILLAR	p ih l er
PILLARS	p ih l er z
PILLING	p ih l ih ng
PILLOW	p ih l ow
PILOTED	p ay l ah t ih d
PILOTS	p ay l ah t s
PILTZ	p ih l t s
PIMPING	p ih m p ih ng
PIMPLE	p ih m p ah l
PINARD	p ih n er d
PINCHER	p ih n ch er
PINEDO	p iy n ey d ow
PINES	p ay n z
PINGREE	p ih ng g r iy
PINING	p ay n ih ng
PINKS	p ih ng k s
PINN	p ih n
PINOLA	p ih n ow l ah
PINSHAN	p ih n sh ah n
PINSKER	p ih n s k er
PINTS	p ay n t s
PION	p ay aa n
PIPE	p ay p
PIPED	p ay p t
PIPER	p ay p er
PIRACY	p ay r ah s iy
PIRATE	p ay r ah t
PIRKEY	p er k iy
PIRTLE	p er t ah l
PISANI	p iy s aa n iy
PISSED	p ih s t
PISTOLS	p ih s t ah l z
PITFALL	p ih t f ao l
PITRE	p ay t er
PITSWON	p ih t s w aa n
PITYING	p ih t iy ih ng
PIVONKA	p ih v aa ng k ah
PIVOTAL	p ih v ah t ah l
PIZANA	p iy z ae n ah
PIZZAS	p iy t s ah z
PIZZUTI	p iy t s uw t iy
PLACIDA	p l aa ch iy d ah
PLACK'S	p l ae k s
PLACKO	p l ae k ow
PLAGUED	p l ey g d
PLAGUES	p l ey g z
PLAIN	p l ey n
PLAIT	p l ey t
PLAITED	p l ey t ah d
PLANCK	p l ae ng k
PLANS'	p l ae n z
PLAS	p l ae s
PLATEAU	p l ae t ow
PLATEN	p l ae t ah n
PLAYERS	p l ey er z
PLAYING	p l ey ih ng
PLEIN	p l iy n
PLESE	p l iy z
PLETT	p l eh t
PLEVA	p l ey v ah
PLEX	p l eh k s
PLINIUS	p l ih n iy ah s
PLOETZ	p l ow t s
PLOSS	p l ao s
PLOTTED	p l aa t ah d
PLOUGH	p l aw
PLOWS	p l aw z
PLUMBED	p l ah m d
PLUMER	p l uw m er
PLUMS	p l ah m z
PLUNGES	p l ah n jh ih z
PLUNKED	p l ah ng k t
PLUS	p l ah s
PLUTO'S	p l uw t ow z
PLY	p l ay
PLYLER	p l ay l er
PM	p iy eh m
POARCH	p ao r hh
POCONO	p ow k ah n ow
POCONOS	p ow k ah n ow z
PODESTA	p ow d eh s t ah
PODGE	p aa jh
POEHL	p ow l
POEM	p ow ah m
POGO	p ow g ow
POHLE	p ow hh ah l
POHNPEI	p ow n p ey
POINTS	p oy n t s
POITRA	p oy t r ah
POITRAS	p oy t r aa z
POKER	p ow k er
POKING	p ow k ih ng
POLACEK	p aa l ah ch eh k
POLAR	p ow l er
POLI	p ow l iy
POLICY	p aa l ah s iy
POLITIC	p aa l ah t ih k
POLITIS	p aa l ay t ih s
POLITY	p aa l ah t iy
POLLEN	p aa l ah n
POLLINA	p ow l iy n ah
POLLOCK	p aa l ah k
POLO	p ow l ow
POLSKIN	p aa l s k ih n
POLSKY	p ow l s k iy
POLSTON	p ow l s t ah n
POMP	p aa m p
POMPER	p aa m p er
POMPOM	p aa m p aa m
POND'S	p aa n d z
PONT	p aa n t
PONT'S	p aa n t s
POOLS	p uw l z
POON	p uw n
POOSER	p uw z er
POPA	p ow p ah
POPICK	p aa p ih k
POPOFF	p aa p ao f
POPOVIC	p aa p ah v ih k
POPPEA	p aa p iy ah
POPPERS	p aa p er z
POPPY'S	p aa p iy z
POPS	p aa p s
POR	p ao r
PORCARO	p ao r k aa r ow
PORCH	p ao r ch
PORGES	p ao r jh ih z
PORT'S	p ao r t s
PORTELA	p ao r t eh l ah
POSCH	p ao sh
POSS	p ao s
POST	p ow s t
POSTINO	p ao s t iy n ow
POSTIT	p ow s t ih t
POSTREL	p ao s t r eh l
POSTS	p ow s t s
POTENT	p ow t ah n t
POTT	p aa t
POUCHER	p aw ch er
POUPARD	p uw p er d
POURS	p ao r z
POUTING	p aw t ih ng
POUTS	p aw t s
POWTER	p aw t er
PRANCER	p r ae n s er
PRATO	p r aa t ow
PRAXAIR	p r ae k s eh r
PRAYTOR	p r ey t er
PREACHY	p r iy ch iy
PRECHT	p r eh k t
PRECIP	p r eh s ih p
PREFERS	p r ah f er z
PREM	p r eh m
PREMO	p r eh m ow
PREPUCE	p r eh p y uw s
PRESALE	p r iy s ey l
PRESCOT	p r eh s k ah t
PRESET	p r iy s eh t
PRESLER	p r eh s ah l er
PRESSEY	p r eh s iy
PRESSLY	p r eh s l iy
PRESTON	p r eh s t ah n
PRETEXT	p r iy t eh k s t
PRETTI	p r eh t iy
PREVITI	p r eh v iy t iy
PREYING	p r ey ih ng
PRICK	p r ih k
PRICKLY	p r ih k l iy
PRILL	p r ih l
PRIMA	p r iy m ah
PRIMACY	p r ay m ah s iy
PRIMO'S	p r iy m ow z
PRINCES	p r ih n s ah z
PRINKEY	p r ih ng k iy
PRINTED	p r ih n t ah d
PRINZ'S	p r ih n z ah z
PRIOR	p r ay er
PRIORY	p r ay er iy
PRIS	p r ih s
PRISON	p r ih z ah n
PRISONS	p r ih z ah n z
PRIZM	p r ih z ah m
PRODUC	p r ow d uw k
PRODUCE	p r ah d uw s
PROFITS	p r aa f ih t s
PROFITT	p r aa f ih t
PROMS	p r aa m z
PROOFED	p r uw f t
PROPER	p r aa p er
PROPES	p r ow p s
PROSEK	p r ow s eh k
PROSISE	p r ow s ay z
PROTEGE	p r ow t ah zh ey
PROUT	p r aw t
PROVOST	p r ow v ow s t
PROWS	p r aw z
PROXIES	p r aa k s iy z
PRUSKI	p r ah s k iy
PRUSS	p r ah s
PRYCE	p r ay s
PRYING	p r ay ih ng
PRYNNE	p r ih n
PSYCHE	s ay k iy
PSYCHES	s ay k iy z
PTOLEMY	t aa l ah m iy
PUBLICS	p ah b l ih k s
PUCCINI	p uw ch iy n iy
PUCCIO	p uw ch iy ow
PUCILLO	p uw ch ih l ow
PUDER	p y uw d er
PUEBLO	p w eh b l ow
PUENTES	p w eh n t eh s
PUKE	p y uw k
PULEO	p uw l iy ow
PULL	p uh l
PULLING	p uh l ih ng
PULLS	p uh l z
PULLUM	p uh l ah m
PULPITS	p uh l p ih t s
PULVER	p uh l v er
PUMSIE	p ah m z iy
PUN	p ah n
PUNK	p ah ng k
PUOPOLO	p w ow p ow l ow
PURDIE	p er d iy
PURDIN	p er d ih n
PURDOM	p er d ah m
PURE	p y uh r
PURER	p y uh r er
PURI	p uh r iy
PURILE	p y uw r ah l
PURIST	p y uh r ih s t
PURPLES	p er p ah l z
PURSE	p er s
PUSCH	p ah sh
PUSSES	p uh s ih z
PUTNEY	p ah t n iy
PUTTS	p ah t s
PUTZIER	p ah t z iy er
PUZIO	p uw z iy ow
PYLANT	p ih l ao n t
PYLE'S	p ay l z
PYLONS	p ay l aa n z
QASR	k ey z er
QINTEX	k ih n t eh k s
QUALMS	k w aa m z
QUAN	k w ao n
QUANTUM	k w aa n t ah m
QUARK	k w aa r k
QUARTO	k w ao r t ow
QUASI	k w aa s iy
QUASSIA	k w aa sh iy ah
QUAVERS	k w ey v er z
QUEASY	k w iy z iy
QUECHEE	k w eh ch iy
QUEL	k w eh l
QUERIES	k w ih r iy z
QUEUING	k y uw ih ng
QUICHE	k iy sh
QUICKIE	k w ih k iy
QUIETER	k w ay ah t er
QUIETLY	k w ay ah t l iy
QUINA'S	k w iy n ah z
QUINON	k w ih n ah n
QUIPPED	k w ih p t
QUIRIN	k w ih r ih n
QUIRING	k w ay r ih ng
QUIRKS	k w er k s
QUIZ	k w ih z
QUIZZED	k w ih z d
QUORUM	k w ao r ah m
QUOTE	k w ow t
QUOTED	k w ow t ih d
QUOTES	k w ow t s
R.	aa r
RABBITT	r ae b ih t
RABER	r ey b er
RABIN	r aa b iy n
RABUKA	r ah b uw k ah
RABUN	r ae b ah n
RABURN	r ae b er n
RACE	r ey s
RACHAD	r ah sh aa d
RADANT	r aa d ah n t
RADBURN	r ae d b er n
RADLE	r ey d ah l
RADLER	r ey d ah l er
RADMAN	r ae d m ah n
RADNOR	r ae d n er
RADOLF	r ae d ow l f
RADON	r ey d aa n
RAF	r ae f
RAGGED	r ae g ah d
RAGIN	r ae jh ih n
RAGLE	r ey g ah l
RAGWEED	r ae g w iy d
RAHILLY	r ae hh ah l iy
RAILE	r ey l
RAILEY	r ey l iy
RAILING	r ey l ih ng
RAINA	r ey n ah
RAINER	r ey n er
RAINEY	r ey n iy
RAINGER	r aa ih ng er
RAINMAN	r ey n m ah n
RAITT	r ey t
RAJIV	r aa jh iy v
RAK	r ae k
RAKED	r ey k t
RAKIYA	r ah k iy ah
RALF	r aa l f
RALLIS	r ae l ih s
RALLY	r ae l iy
RALLY'S	r ae l iy z
RAMAKER	r aa m ey k er
RAMALA	r ah m aa l ah
RAMAN	r ey m ah n
RAMBERT	r ae m b er t
RAMBLED	r ae m b ah l d
RAMEL	r ae m ah l
RAMLER	r ae m l er
RAMON	r ah m ow n
RAMPY	r ae m p iy
RAMROD	r ae m r aa d
RAMSEY	r ae m z iy
RANDAL	r ae n d ah l
RANDER	r ae n d er
RANDOLF	r ae n d ow l f
RANFT	r ae n f t
RANGY	r ey n jh iy
RANKIN	r ae ng k ih n
RANKLE	r ae ng k ah l
RANNEY	r ae n iy
RANTED	r ae n t ah d
RAO	r aw
RAPHAEL	r aa f ay eh l
RAPOZO	r aa p ow z ow
RAPP	r ae p
RAPS	r ae p s
RAPT	r ae p t
RAPTOR	r ae p t er
RAREFY	r eh r ah f ay
RARELY	r eh r l iy
RASIA	r aa s iy ah
RASKYN	r ae s k ih n
RASMIN	r ae s m ah n
RASPY	r ae s p iy
RATAY	r ae t ey
RATH	r ae th
RATHBUN	r ae th b ah n
RATHE	r ey dh
RATION	r ae sh ah n
RATTNER	r ae t n er
RAUB	r ao b
RAUER	r aw er
RAULS	r aa uw l z
RAUM	r ao m
RAVENS	r ey v ah n z
RAVIN	r ae v ih n
RAWHIDE	r ao hh ay d
RAYBON	r ey b ah n
RAYFORD	r ey f er d
RAYMENT	r ey m ah n t
RAYMUND	r ey m ah n d
RAYNARD	r ey n er d
RAYNET	r ey n eh t
RAYTECH	r ey t eh k
RAZ	r ae z
REACTED	r iy ae k t ah d
READE	r eh d
READIED	r eh d iy d
REAGAN	r ey g ah n
REAL	r iy l
REAPS	r iy p s
REASON	r iy z ah n
REBA	r iy b ah
REBATE	r iy b ey t
REBATED	r iy b ey t ih d
REBEL	r eh b ah l
REBERT	r eh b er t
REBOUND	r iy b aw n d
REBUS	r iy b ah s
REC	r eh k
RECALLS	r iy k ao l z
RECAP	r iy k ae p
RECEIPT	r ih s iy t
RECESS	r ih s eh s
RECIPE	r eh s ah p iy
RECITED	r ah s ay t ah d
RECKONS	r eh k ah n z
RECOIL	r iy k oy l
RECORD	r ah k ao r d
REDBIRD	r eh d b er d
REDBUD	r eh d b ah d
REDDISH	r eh d ih sh
REDEEMS	r ah d iy m z
REDEYES	r eh d ay z
REDFORD	r eh d f er d
REDISH	r eh d ih sh
REDLER	r eh d l er
REDWINE	r eh d w ay n
REDWOOD	r eh d w uh d
REEBS	r iy b z
REECE	r iy s
REECK	r iy k
REED	r iy d
REELECT	r iy ih l eh k t
REELING	r iy l ih ng
REENTRY	r iy ih n t r iy
REESE'S	r iy s ih z
REF	r eh f
REFAAT	r ah f aa t
REFER	r ah f er
REFILL	r iy f ih l
REFSNES	r eh f s n iy z
REFUGES	r eh f y uw jh ih z
REFUNDS	r ih f ah n d z
REGALED	r ih g ey l d
REGEHR	r eh g ih r
REGENTS	r iy jh ah n t s
REGIE	r eh g iy
REGIONS	r iy jh ah n z
REGRESS	r iy g r eh s
REHIRE	r iy hh ay r
REIBEL	r ay b ah l
REICH'S	r ay k s
REICHL	r ay k ah l
REICHOW	r ay k ow
REID'S	r iy d z
REIER	r ey er
REIGER	r ay g er
REIGNS	r ey n z
REIMANN	r ay m ah n
REIMS	r iy m z
REINEKE	r ay n ih k
REINES	r ey n z
REINS	r ey n z
REINTS	r ay n t s
REISER	r ay s er
REISERT	r ay s er t
REISIG	r ay s ih g
REIST	r iy ih s t
REITS	r ay t s
REITSMA	r ay t s m ah
RELATE	r ih l ey t
RELAYED	r iy l ey d
RELAYS	r iy l ey z
RELIED	r ih l ay d
RELIEVE	r ih l iy v
REMADE	r iy m ey d
REMAINS	r ih m ey n z
REMAKES	r iy m ey k s
REMALEY	r eh m ah l iy
REMCO	r eh m k ow
REMME	r eh m
REMNANT	r eh m n ah n t
REMOLD	r iy m ow l d
REMPEL	r eh m p ah l
RENDING	r eh n d ih ng
RENDON	r eh n d ow n
RENEW	r ih n uw
RENEWAL	r ih n uw ah l
RENFRED	r eh n f er d
RENFRO	r eh n f r ow
RENISON	r eh n ih s ah n
RENN	r eh n
RENNELS	r eh n ah l z
RENO'S	r iy n ow z
RENOIRS	r eh n w aa r z
RENTAL	r eh n t ah l
REOPEN	r iy ow p ah n
REPAIRS	r ih p eh r z
REPEATS	r ih p iy t s
REPETTI	r eh p eh t iy
REPORT	r iy p ao r t
REPORTS	r ih p ao r t s
REPR	r eh p er
REPSHER	r eh p sh er
REPUTE	r iy p y uw t
REQUEST	r ih k w eh s t
RESCUED	r eh s k y uw d
RESNER	r eh s n er
RESO'S	r iy s ow z
RESOLD	r iy s ow l d
RESOLVE	r iy z aa l v
RESS	r eh s
RETARDS	r ih t aa r d z
RETINUE	r eh t ah n uw
RETINYL	r eh t ih n ah l
RETREAT	r iy t r iy t
RETTEW	r eh ch uw
RETURNS	r ih t er n z
REULAND	r oy l ah n d
REUNIFY	r iy uw n ah f ay
REUSS	r uw s
REUSSER	r oy s er
REUST	r uw s t
REVEAL	r ih v iy l
REVELES	r ey v ey l eh s
REVERED	r ih v ih r d
REVERON	r eh v er aa n
REVILE	r iy v ay l
REVILED	r iy v ay l d
REVOIR	r ih v w aa r
REVOLT	r ih v ow l t
REVVED	r eh v d
REXANA	r ih g z ae n ah
REYBURN	r ey b er n
REYER	r ey er
REYNOSA	r iy n ow s ah
REZABEK	r ih z aa b eh k
REZAC	r eh z ah k
RHAMES	r ey m z
RHEA	r iy ah
RHIZOID	r ay z oy d
RHOTEN	r ow t ah n
RHOTO	r ow t ow
RHYMED	r ay m d
RHYNER	r ay n er
RIALS	r ay l z
RIBA	r iy b ah
RIBALD	r ay b aa l d
RIBAUDO	r iy b ao d ow
RIBEIRO	r iy b eh r ow
RIBI	r iy b iy
RICHEY	r ih ch iy
RICK'S	r ih k s
RICKEN	r ih k ah n
RICO	r iy k ow
RICOH	r iy k ow
RIDABLE	r ay d ah b ah l
RIDEOUT	r ay d aw t
RIDER'S	r ay d er z
RIDNER	r ih d n er
RIDOLFI	r iy d ow l f iy
RIDOUT	r ih d aw t
RIEBER	r iy b er
RIECKE	r iy k
RIED	r iy d
RIEF	r iy f
RIEGERT	r iy g er t
RIEMANN	r iy m ah n
RIESH	r ay sh
RIFFING	r ih f ih ng
RIGEL	r ay jh ah l
RIGGEN	r ih g ah n
RIGGIO	r iy jh iy ow
RIGORS	r ih g er z
RIKE	r ay k
RIMEL	r ih m ah l
RINAS	r ay n ah z
RINGERS	r ih ng er z
RINKER	r ih ng k er
RINSING	r ih n s ih ng
RIO	r iy ow
RIORDAN	r ih r d ah n
RIOTED	r ay ah t ih d
RIPA	r iy p ah
RIPOFFS	r ih p ao f s
RIPPEY	r ih p iy
RISA	r iy s ah
RISE	r ay z
RISEN	r ih z ah n
RISER	r ay z er
RISHEL	r ih sh ah l
RISIN	r ay z ih n
RISPOLI	r iy s p ow l iy
RISQUE	r ih s k ey
RITCH	r ih ch
RITUALS	r ih ch uw ah l z
RIVER	r ih v er
RIVERO	r iy v eh r ow
RIVET	r ih v ah t
RIVETED	r ih v ah t ih d
RIVIERE	r ih v iy eh r
RIX	r ih k s
ROACH	r ow ch
ROAD	r ow d
ROAD'S	r ow d z
ROADY	r ow d iy
ROAM	r ow m
ROAMING	r ow m ih ng
ROAR	r ao r
ROATH	r ow th
ROB	r aa b
ROBB'S	r aa b z
ROBBED	r aa b d
ROBLEE	r aa b l iy
ROBLEY	r aa b l iy
ROBS	r aa b z
ROBUCK	r ow b ah k
ROCAP	r ow k ae p
ROCHE'S	r ow sh ih z
ROCKING	r aa k ih ng
ROCKS	r aa k s
ROCOCO	r ah k ow k ow
RODARTE	r aa d aa r t
RODDEY	r aa d iy
RODDIE	r aa d iy
RODDING	r aa d ih ng
RODER	r ow d er
RODGER	r aa jh er
RODI	r ow d iy
RODICK	r aa d ih k
ROECKER	r ow k er
ROED	r ow d
ROEDL	r ow d ah l
ROEHRIG	r ao r ih g
ROELOFS	r ow l ah f s
ROH	r ow
ROHAN	r ow ah n
ROHRS	r ao r z
ROJO	r ow jh ow
ROLAN	r ow l ah n
ROLETTE	r ow l eh t
ROLLIE	r ow l iy
ROLLINS	r aa l ih n z
ROLLY	r ow l iy
ROLM	r ow m
ROLOFF	r aa l ao f
ROLT	r ow l t
ROMAINE	r ow m ey n
ROMANIA	r ow m ey n iy ah
ROMAS	r ow m ah z
ROMER	r ow m er
ROMILDA	r ah m iy l d ah
ROMNEY	r aa m n iy
RONE	r ow n
RONK	r aa ng k
RONKO	r aa ng k ow
ROOMS	r uw m z
ROOTKIT	r uw t k ih t
ROPS	r aa p s
RORER	r ao r er
ROSA	r ow z ah
ROSALYN	r aa z ah l ih n
ROSE	r ow z
ROSENE	r aa s iy n
ROSER	r ow z er
ROSIER	r ow z iy er
ROSKE	r ow s k
ROSKO	r ow s k ow
ROSMAN	r aa s m ah n
ROSS	r aa s
ROSSING	r ao s ih ng
ROSTEN	r aa s ah n
ROSTER	r aa s t er
ROSY	r ow z iy
ROT	r aa t
ROTAN	r ow t ah n
ROTBLAT	r aa t b l ae t
ROTERT	r aa t er t
ROTO	r ow t ow
ROULAC	r uw l ae k
ROUND	r aw n d
ROUSE'S	r aw z ih z
ROUSSEL	r uw s eh l
ROUTE	r uw t
ROUTH	r aw th
ROUTON	r aw t ah n
ROUTSON	r aw t s ah n
ROVER	r ow v er
ROVER'S	r ow v er z
ROWDEN	r ow d ah n
ROWELL	r ow ih l
ROWER	r ow er
ROWLETT	r ow l ih t
ROX'S	r aa k s ih s
ROXANI	r aa k s aa n iy
ROYALS	r oy ah l z
ROYER	r oy er
ROYSTER	r oy s t er
ROZ	r aa z
ROZELLE	r ah z eh l
RPF	aa r p iy eh f
RPM	aa r p iy eh m
RUBBER	r ah b er
RUBBING	r ah b ih ng
RUBE	r uw b
RUBIE	r uw b iy
RUBIN	r uw b ih n
RUBINO	r uw b iy n ow
RUBIS	r uw b ih s
RUBLE'S	r uw b ah l z
RUBS	r ah b z
RUCHTI	r uw k t iy
RUDA	r uw d ah
RUDANI	r uw d aa n iy
RUDEL	r uw d ah l
RUDING	r uw d ih ng
RUDMAN	r ah d m ah n
RUELLA	r uw eh l ah
RUESCH	r uw sh
RUETH	r uw th
RUFFER	r ah f er
RUHNAU	r uw n aw
RUINED	r uw ah n d
RUINS	r uw ah n z
RULED	r uw l d
RULLO	r uw l ow
RUMANIA	r uw m ey n iy ah
RUMERY	r ah m er iy
RUMLER	r ah m l er
RUMMY	r ah m iy
RUMORE	r uw m ao r
RUMSEY	r ah m z iy
RUNCKEL	r ah ng k ah l
RUNKLES	r ah ng k ah l z
RUNNY	r ah n iy
RUNUPS	r ah n ah p s
RUPARD	r uw p er d
RUPEE	r uw p iy
RUPEES	r uw p iy z
RUPPERT	r ah p er t
RUSELER	r uw s ih l er
RUSHER	r ah sh er
RUSHES	r ah sh ah z
RUSHIN	r ah sh ih n
RUSHING	r ah sh ih ng
RUSHLOW	r ah sh l ow
RUSNAK	r ah s n ah k
RUSTED	r ah s t ah d
RUSTLE	r ah s ah l
RUTILE	r uw t iy l
RUTZ	r ah t s
RUWE	r uw w
RYBACKI	r ih b aa t s k iy
RYCZEK	r ih ch eh k
RYGIEL	r ih g iy l
RYKIEL	r iy k y eh l
RYNER	r ay n er
RYUTARO	r y uw t aa r ow
RZEPKA	er z eh p k ah
S'S	eh s ih z
SAATCHI	s aa ch iy
SAB'S	s ae b z
SABIA	s aa b iy ah
SABINA	s ah b iy n ah
SABIR	s ey b er
SABLAN	s ae b l ah n
SABO	s aa b ow
SABRA	s aa b r ah
SACCONE	s aa k ow n iy
SADISM	s ey d ih z ah m
SADLER	s ae d l er
SADNESS	s ae d n ah s
SAENZ	s iy n z
SAFFIR	s ah f iy r
SAFFRAN	s ae f r ah n
SAFIRE	s ah f ay r
SAGERS	s ey g er z
SAGES	s ey jh ih z
SAGGESE	s ae g iy z
SAHA	s aa hh ah
SAHLEN	s aa l ah n
SAHLIN	s aa l ih n
SAHM	s ae m
SAIF	s aa iy f
SAINTS'	s ey n t s
SAITAMA	s aa ih t aa m ah
SAJDAK	s ay d ah k
SAKAU	s aa k aa uw
SAKE	s ey k
SAKES	s ey k s
SALAAM	s ah l aa m
SALAH	s ae l ah
SALAMA	s aa l aa m ah
SALAMI	s ah l aa m iy
SALAMIS	s ah l aa m iy z
SALDANA	s aa l d ae n ah
SALEEM	s ae l iy m
SALEM'S	s ey l ah m z
SALEMI	s aa l eh m iy
SALES	s ey l z
SALICK	s ae l ih k
SALIF	s ah l iy f
SALIS	s aa l ih s
SALMON	s ae m ah n
SALO	s aa l ow
SALOON	s ah l uw n
SALSA	s ao l s ah
SALSER	s ey l s er
SALTIER	s ao l t iy er
SALYER	s aa l iy er
SAMARA	s ae m er ah
SAMARIA	s ey m er iy ah
SAMBERG	s ae m b er g
SAME	s ey m
SAMEK	s ae m ih k
SAMMS	s ae m z
SAMOA	s ah m ow ah
SAMPEY	s ae m p iy
SAMPLER	s ae m p l er
SAMPSEL	s ae m p s ah l
SAMRA	s ae m r ah
SAMS	s ae m z
SAMSEL	s ae m s ah l
SAMUEL	s ae m y uw l
SANA	s aa n ah
SANCHEZ	s ae n ch eh z
SAND	s ae n d
SANDBOX	s ae n d b aa k s
SANDE	s ae n d
SANDED	s ae n d ih d
SANDHU	s ae n d hh uw
SANDINO	s ae n d iy n ow
SANDOM	s ae n d ah m
SANDOW	s ae n d ow
SANDS	s ae n d z
SANDVIG	s ae n d v ih g
SANGYO	s ae n jh y ow
SANITY	s ae n ah t iy
SANJAY	s ae n jh ey
SANKO	s ae ng k ow
SANKS	s ae ng k s
SANSONE	s ae n s ah n
SANT	s ae n t
SANTINO	s aa n t iy n ow
SANTO	s ae n t ow
SANTONE	s aa n t ow n iy
SANTORA	s aa n t ao r ah
SANTRY	s ae n t r iy
SANWA	s ae n w ah
SAPHIRA	s aa f ih r ah
SAPPORO	s ah p ao r ow
SARABIA	s er ey b iy ah
SARBER	s aa r b er
SARCASM	s aa r k ae z ah m
SARCHET	s aa r sh eh t
SARRATT	s er ae t
SARTAIN	s aa r t ey n
SAS	s ae s
SASAKI	s aa s aa k iy
SASSER	s ae s er
SASSNET	s ae s n eh t
SAUDER	s ao d er
SAUDIS'	s ao d iy z
SAUNTER	s ao n t er
SAURER	s aw er r
SAUSSER	s ao s er
SAUTEED	s ao t ey d
SAUVE	s ao v
SAVANTS	s ae v ah n t s
SAVES	s ey v z
SAVIKAS	s ah v iy k ah s
SAVIO	s aa v iy ow
SAVIORS	s ey v y er z
SAVON	s ey v ao n
SAW	s ao
SAWALL	s ao w ao l
SAWMILL	s ao m ih l
SAWS	s ao z
SAWYER	s ao y er
SAYEGH	s ey ih g
SAYIID	s ay ih d
SAYLE	s ey l
SBARRO	s b aa r ow
SCALA	s k aa l ah
SCALAR	s k ey l er
SCALESE	s k aa l ey z iy
SCALISI	s k aa l iy s iy
SCALLY	s k ae l iy
SCAMMER	s k ae m er
SCAMPER	s k ae m p er
SCARE	s k eh r
SCARY	s k eh r iy
SCENIC	s iy n ih k
SCHAAP	sh aa p
SCHAAR	sh aa r
SCHABER	sh ey b er
SCHABES	sh ey b z
SCHACHT	sh ae k t
SCHADEN	sh ae d ah n
SCHADER	sh ey d er
SCHAER	sh aa er
SCHARF	sh aa r f
SCHAUER	sh aw er
SCHAUL	sh ow l
SCHAUT	sh ow t
SCHEAR	sh ih r
SCHECK	sh eh k
SCHEMEL	sh eh m ah l
SCHERB	sh er b
SCHERF	sh er f
SCHERR	sh eh r
SCHERTZ	sh er t s
SCHIESS	sh iy s
SCHILKE	sh ih l k
SCHILT	sh ih l t
SCHLAG	sh l ae g
SCHLAKE	sh l ey k
SCHLIEP	sh l iy p
SCHLOSS	sh l ao s
SCHMEAD	sh m iy d
SCHMEHL	sh m eh l
SCHMELZ	sh m eh l z
SCHMID	sh m ih d
SCHMIDT	sh m ih t
SCHNICK	sh n ih k
SCHNORR	sh n ao r
SCHOEN	sh ow n
SCHONE	sh ow n
SCHOO	sh uw
SCHOOK	sh uh k
SCHOOL	s k uw l
SCHOPP	sh aa p
SCHOU	sh uw
SCHRANK	sh r ae ng k
SCHROFF	sh r ao f
SCHUETT	s k uw t
SCHULD	sh uh d
SCHULDT	sh uh l t
SCHULL	sh uh l
SCHULOF	sh uw l ao f
SCHULTE	sh ah l t
SCHULZE	sh uh l t s
SCHUM	sh ah m
SCHUMAN	sh uw m ah n
SCHUPAK	sh uw p ae k
SCHUTZ	sh ah t s
SCHUUR	sh uh r
SCHWAHN	sh w ao n
SCHWARZ	sh w ao r t s
SCHWENK	sh w eh ng k
SCHWER	sh w er
SCIENCE	s ay ah n s
SCIMED	s ay m eh d
SCOLDED	s k ow l d ah d
SCOOT	s k uw t
SCORED	s k ao r d
SCOTS	s k aa t s
SCOTTO	s k ow t ow
SCOURGE	s k er jh
SCOVELL	s k aa v ah l
SCRAPS	s k r ae p s
SCRIP	s k r ih p
SCROD	s k r aa d
SCRONCE	s k r aa n s
SCRUTON	s k r uw t ah n
SCYTHE	s ih th
SEABEE	s iy b iy
SEACO	s iy k ow
SEAGATE	s iy g ey t
SEALAND	s iy l ae n d
SEALY	s iy l iy
SEAMON	s iy m ah n
SEAMS	s iy m z
SEARCH	s er ch
SEASONS	s iy z ah n z
SEATS	s iy t s
SEATTLE	s iy ae t ah l
SEAVEY	s iy v iy
SEBEK	s eh b ih k
SEBESTA	s eh b eh s t ah
SEBRING	s iy b r ih ng
SECRECY	s iy k r ah s iy
SECTEUR	s eh k t uw r
SECURE	s ih k y uh r
SEDANS	s ih d ae n z
SEDGE	s eh jh
SEDIVY	s eh d ih v iy
SEDLER	s eh d l er
SEEBACH	s iy b aa k
SEEBOLD	s iy b ow l d
SEEKING	s iy k ih ng
SEEKONK	s iy k aa ng k
SEES	s iy z
SEETIN	s iy t ih n
SEEVER	s iy v er
SEEVERS	s iy v er z
SEGUE	s eh g
SEIBU	s ay b uw
SEIKI	s ey k iy
SEILS	s ay l z
SEISER	s ay s er
SEITA	s ey t ah
SEITMAN	s iy t m ah n
SEIZE	s iy z
SEIZES	s iy z ih z
SELDERS	s eh l d er z
SELF	s eh l f
SELKIRK	s eh l k er k
SELL	s eh l
SELLE	s eh l
SELLERS	s eh l er z
SELLNER	s eh l n er
SELLOFF	s eh l ao f
SELMAN	s eh l m ah n
SELZ	s eh l z
SEMANS	s iy m ah n z
SEMEN	s iy m ah n
SEMRAD	s eh m r ah d
SENATOR	s eh n ah t er
SENDER	s eh n d er
SENDING	s eh n d ih ng
SENDS	s eh n d z
SENECAL	s eh n ih k ah l
SENEGAL	s eh n ah g ao l
SENEKER	s eh n ah k er
SENF	s eh n f
SENNER	s eh n er
SENOR	s iy n y ao r
SENORA	s iy n y ao r ah
SENSES	s eh n s ih z
SENTELL	s eh n t ah l
SEO	s iy ow
SEOUL'S	s ow l z
SEPIA	s iy p iy ah
SEPT	s eh p t
SEPTIC	s eh p t ih k
SEPTIMA	s eh p t iy m ah
SEQUA	s eh k w ah
SEQUEL	s iy k w ah l
SERAGUT	s eh r ah g ah t
SERE	s ih r
SERLE	s er ah l
SERONO	s eh r aa n ow
SERRA	s eh r ah
SERVAM	s er v ah m
SERVICO	s er v ih k ow
SERVILE	s er v ah l
SERVING	s er v ih ng
SETO	s eh t ow
SETTSU	s eh t s uw
SEVENS	s eh v ah n z
SEVERNS	s eh v er n z
SEVERT	s eh v er t
SEVEY	s ih v ey
SEWERS	s uw er z
SEXLESS	s eh k s l ih s
SEYFERT	s ey f er t
SEYLLER	s ey l er
SHAD'S	sh ae d z
SHADD	sh ae d
SHADDEN	sh ae d ah n
SHADEL	sh ae d ah l
SHADER	sh ey d er
SHAFF	sh ae f
SHAHIDI	sh ah hh iy d iy
SHAHIN	sh ae hh ih n
SHAKA	sh aa k ah
SHAKERS	sh ey k er z
SHALE	sh ey l
SHALT	sh ae l t
SHAMAN	sh ey m ah n
SHAMP	sh ae m p
SHAND	sh ae n d
SHANT	sh aa n t
SHAPING	sh ey p ih ng
SHARAA	sh aa r ah
SHARE	sh eh r
SHARI	sh aa r iy
SHARMAN	sh aa r m ah n
SHARPY	sh aa r p iy
SHARRAR	sh er aa r
SHATZER	sh ey t z er
SHAUB	sh ao b
SHAVEN	sh ey v ah n
SHAVER	sh ey v er
SHAVERS	sh ey v er z
SHAWGO	sh ao g ow
SHEAR	sh ih r
SHEAR'S	sh iy r z
SHEARD	sh ih r d
SHEARED	sh ih r d
SHEARON	sh ih r ah n
SHEBEK	sh eh b ah k
SHECK'S	sh eh k s
SHEEPS	sh iy p s
SHEER	sh ih r
SHEET	sh iy t
SHEHANE	sh eh hh ah n
SHEIK'S	sh iy k s
SHELDEN	sh eh l d ah n
SHELF	sh eh l f
SHELL	sh eh l
SHELL'S	sh eh l z
SHELMAN	sh eh l m ah n
SHELP	sh eh l p
SHEMA	sh ih m ah
SHERARD	sh eh r er d
SHERE	sh ih r
SHEROD	sh eh r ah d
SHERVA	sh er v ah
SHERWIN	sh er w ih n
SHIAH	sh iy ah
SHIAS	sh iy ah z
SHIHAN	sh iy hh aa n
SHIMBUN	sh ih m b ah n
SHIMEK	sh ih m ih k
SHINER	sh ay n er
SHINKO	sh ih ng k ow
SHIPES	sh ay p s
SHIPMAN	sh ih p m ah n
SHIPP	sh ih p
SHIRA	sh ih r ah
SHIREY	sh ay r iy
SHIRKED	sh er k t
SHIRLEE	sh er l iy
SHIVLEY	sh ih v l iy
SHIZUKA	sh ih z uw k ah
SHOGREN	sh aa g r eh n
SHONE	sh ow n
SHOPTAW	sh aa p t ao
SHORIN	sh ao r ih n
SHORKEY	sh ao r k iy
SHORTEN	sh ao r t ah n
SHORTER	sh ao r t er
SHOT	sh aa t
SHOUPE	sh uw p
SHOUSE	s hh aw s
SHOVE	sh ah v
SHOVING	sh ah v ih ng
SHOVLIN	sh aa v l ih n
SHOWERS	sh aw er z
SHRAMEK	sh r ae m ih k
SHREWD	sh r uw d
SHRIBER	sh r ay b er
SHRINES	sh r ay n z
SHUFF	sh ah f
SHUGRUE	sh ah g r uw
SHULMAN	sh uh l m ah n
SHULTZ	sh uh l t s
SHUM	sh ah m
SHUMAN	sh uw m ah n
SHUMEET	sh uw m iy t
SHUNTS	sh ah n t s
SHUPING	sh uw p ih ng
SHUR	sh er
SHURTZ	sh er t s
SHUT	sh ah t
SHUTE	sh uw t
SHUTTS	sh ah t s
SHY	sh ay
SHYJAN	sh ay jh ae n
SIBBY	s ih b iy
SIBERT	s ih b er t
SIBILIA	s iy b iy l iy ah
SIBYLL	s ih b ih l
SICHEL	s ih k ah l
SICOTTE	s ih k ao t
SIDAK	s ih d ae k
SIDEMAN	s ay d m ae n
SIDHU	s ih d hh uw
SIDI	s ih d iy
SIDLES	s ay d ah l z
SIDWELL	s ih d w eh l
SIEBERS	s iy b er z
SIEJA	s ey ah
SIEM	s iy m
SIEMER	s iy m er
SIEVERS	s iy v er z
SIEVING	s ih v ih ng
SIEWERT	s iy w er t
SIGGERS	s ih g er z
SIGNAL	s ih g n ah l
SILER	s ay l er
SILKY	s ih l k iy
SILMAN	s ih l m ah n
SILVERS	s ih l v er z
SILVIO	s ih l v iy ow
SIMEK	s ih m ih k
SIMI	s iy m iy
SIMMONS	s ih m ah n z
SIMONA	s ih m ow n ah
SIMONI	s iy m ow n iy
SIMONS	s ay m ah n z
SIMONY	s ay m ah n iy
SIMPSON	s ih m p s ah n
SINCE	s ih n s
SINFUL	s ih n f ah l
SINGH	s ih ng
SINGLES	s ih ng g ah l z
SINKER	s ih ng k er
SINKLER	s ih ng k l er
SINKO	s ih ng k ow
SINUOUS	s ih n w ah s
SINYARD	s ih n y aa r d
SIOUX	s uw
SIP	s ih p
SIPLE	s ay p ah l
SIRAVO	s ih r aa v ow
SIRMON	s er m ah n
SISCO	s iy s k ow
SISKIND	s ih s k ih n d
SISLER	s ih s ah l er
SISTO	s ih s t ow
SITED	s ay t ih d
SITLER	s ay t ah l er
SITTERS	s ih t er z
SIX	s ih k s
SIXED	s ih k s t
SIXFOLD	s ih k s f ow l d
SIZZLIN	s ih z l ih n
SJOBERG	sh ow b er g
SKANDIA	s k ae n d iy er
SKEEL	s k iy l
SKEES	s k iy z
SKEETE	s k iy t
SKENDER	s k eh n d er
SKEWER	s k y uw er
SKI	s k iy
SKIBBE	s k ih b
SKILTON	s k ih l t ah n
SKIMMED	s k ih m d
SKOLNIK	s k ow l n ih k
SKUDRA	s k uw d r ah
SKUFCA	s k ah f k ah
SKULL	s k ah l
SKURA	s k uh r ah
SLAB	s l ae b
SLACKS	s l ae k s
SLADKY	s l ae d k iy
SLAINE	s l ey n
SLAPPEY	s l ae p iy
SLASHER	s l ae sh er
SLATTER	s l ae t er
SLAVERY	s l ey v er iy
SLAVICK	s l ae v ih k
SLENTZ	s l eh n t s
SLEPT	s l eh p t
SLIMS	s l ih m z
SLIMY	s l ay m iy
SLINKER	s l ih ng k er
SLITHER	s l ih dh er
SLIVA	s l iy v ah
SLOCUM	s l ow k ah m
SLOMSKI	s l aa m s k iy
SLOPER	s l ow p er
SLOTT	s l aa t
SLOUCH	s l aw ch
SLOVER	s l ow v er
SLOVO	s l ow v ow
SLOWEST	s l ow ah s t
SLUDGY	s l ah jh iy
SLUGGED	s l ah g d
SLUITER	s l uw t er
SLUMBER	s l ah m b er
SLURRY	s l er iy
SLUTSKY	s l ah t s k iy
SLUTZ	s l ah t s
SMAIL	s m ey l
SMALLS	s m ao l z
SMARTEN	s m aa r t ah n
SMARTS	s m aa r t s
SMASHER	s m ae sh er
SMEE	s m iy
SMIGIEL	s m ih jh iy l
SMILES	s m ay l z
SMITH'S	s m ih th s
SMITS	s m ih t s
SMOG	s m aa g
SMOGGY	s m ao g iy
SMOKED	s m ow k t
SMOKEY	s m ow k iy
SMOLAK	s m ow l ah k
SMOOT	s m uw t
SMOSH	s m uh sh
SMOTHER	s m ah dh er
SMUGLY	s m ah g l iy
SMYTH	s m ay th
SNAGS	s n ae g z
SNARED	s n eh r d
SNECMA	s n eh k m aa
SNEE	s n iy
SNEED	s n iy d
SNEERS	s n ih r z
SNELL	s n eh l
SNIFFER	s n ih f er
SNIFFS	s n ih f s
SNIPER	s n ay p er
SNIPERS	s n ay p er z
SNIPES	s n ay p s
SNOOK	s n uh k
SNOOTY	s n uw t iy
SNORT	s n ao r t
SNOWDON	s n ow d ah n
SNOWE	s n ow
SNUFF	s n ah f
SNUGLY	s n ah g l iy
SOARS	s ao r z
SOBBING	s aa b ih ng
SOBIECH	s aa b iy hh
SOBOTA	s ah b ow t ah
SOCCER	s aa k er
SOCIETY	s ah s ay ah t iy
SOCK	s aa k
SOCKETS	s aa k ah t s
SOENS	s ow n z
SOFFEL	s ao f ah l
SOFFER	s ao f er
SOFIA	s ow f iy ah
SOFIAN	s ow f iy ah n
SOFIE	s aa f iy
SOFITEL	s aa f ah t eh l
SOILEAU	s oy l ow
SOJOURN	s ow jh er n
SOKOLIN	s aa k ah l ih n
SOLDNER	s ow l d n er
SOLECKI	s ah l eh t s k iy
SOLEIL	s ow l ey l
SOLIDLY	s aa l ah d l iy
SOLIZ	s ow l iy z
SOLO	s ow l ow
SOLOIST	s ow l ow ah s t
SOLT	s ow l t
SOLTYS	s ow l t iy z
SOM	s aa m
SOMER	s ah m er
SONATA	s ah n aa t ah
SONDRA	s aa n d r ah
SONEX	s ow n ah k s
SONGY	s aa n jh iy
SONIA	s ow n y ah
SONNETS	s aa n ih t s
SOONEST	s uw n ah s t
SOOT	s uh t
SOPER	s ow p er
SOPRANO	s ah p r aa n ow
SOPS	s aa p s
SORENTO	s er eh n t ow
SORGEN	s ao r g ah n
SORIA	s ao r iy ah
SORUS	s ao r ah s
SOSKIN	s aa s k ih n
SOSUKE	s ow s uw k ey
SOUDERS	s aw d er z
SOULIER	s uw l iy er
SOUND	s aw n d
SOUND'S	s aw n d z
SOUNDS	s aw n d z
SOUR	s aw er
SOUTHER	s ah dh er
SOUTHS	s aw th s
SOUZAS	s uw z ah z
SOVEY	s ow v iy
SOWDER	s ow d er
SOWED	s aw d
SOWER	s ow er
SOWERS	s ow er z
SOWLE	s ow l
SOYA	s oy ah
SOYKA	s oy k ah
SPACERS	s p ey s er z
SPACES	s p ey s ah z
SPADE	s p ey d
SPAETH	s p iy th
SPAHR	s p aa r
SPAKE	s p ey k
SPALL	s p ao l
SPANIER	s p ae n y er
SPARED	s p eh r d
SPARLIN	s p aa r l ih n
SPATS	s p ae t s
SPEAR	s p ih r
SPECKLE	s p eh k ah l
SPECS	s p eh k s
SPEEDS	s p iy d z
SPERM	s p er m
SPERO	s p eh r ow
SPEW	s p y uw
SPEWED	s p y uw d
SPICER	s p ay s er
SPIDELL	s p ih d ah l
SPIGNER	s p ay g n er
SPILKER	s p ih l k er
SPILLED	s p ih l d
SPINACH	s p ih n ah ch
SPINS	s p ih n z
SPIRITO	s p ih r iy t ow
SPIRITS	s p ih r ih t s
SPLENIC	s p l eh n ih k
SPLITS	s p l ih t s
SPOARER	s p ao r er
SPOCK	s p aa k
SPOILED	s p oy l d
SPOOKY	s p uw k iy
SPOOR'S	s p uh r z
SPORCK	s p ao r k
SPOTO	s p ow t ow
SPOTTER	s p aa t er
SPRANG	s p r ae ng
SPREES	s p r iy z
SPRIZZO	s p r ih z ow
SPUD	s p ah d
SPUDS	s p ah d z
SQUALID	s k w aa l ah d
SQUARED	s k w eh r d
SQUAWK	s k w ao k
SQUIRTS	s k w er t s
SQUISHY	s k w ih sh iy
SQUYRES	s k w ay r z
SR	s iy n y er
STAAB	s t aa b
STAACK	s t aa k
STABLES	s t ey b ah l z
STACY	s t ey s iy
STADIA	s t ey d iy ah
STADLER	s t ae d l er
STAGER	s t ey jh er
STAHLY	s t ae l iy
STAHMER	s t aa m er
STAIGER	s t ay g er
STAKED	s t ey k t
STALIN	s t aa l ah n
STALTER	s t ao l t er
STAMMEN	s t ae m ah n
STAMMER	s t ae m er
STAMPER	s t ae m p er
STAN'S	s t ae n z
STANKO	s t ae ng k ow
STANO	s t aa n ow
STANWAY	s t ae n w ey
STAPEL	s t ae p ah l
STAPH	s t ae f
STARES	s t eh r z
STARLIT	s t aa r l ih t
STARMER	s t aa r m er
STARRED	s t aa r d
STARTER	s t aa r t er
STARVED	s t aa r v d
STASHED	s t ae sh t
STASSI	s t ae s iy
STATE'S	s t ey t s
STATES	s t ey t s
STATTIN	s t ae t ih n
STATUE	s t ae ch uw
STATURE	s t ae ch er
STAVROS	s t ah v r ow z
STEAK	s t ey k
STEALTH	s t eh l th
STEBER	s t iy b er
STEDMAN	s t eh d m ah n
STEEB	s t iy b
STEEL'S	s t iy l z
STEELS	s t iy l z
STEELY	s t iy l iy
STEFFAN	s t eh f ah n
STEFFEK	s t eh f ih k
STEFFEY	s t eh f iy
STEIMEL	s t ay m ah l
STEINLE	s t ay n ah l
STELCO	s t eh l k ow
STELIAN	s t iy l iy ah n
STELTER	s t eh l t er
STENCIL	s t eh n s ih l
STENGER	s t eh n jh er
STEPHEN	s t iy v ah n
STEPPES	s t eh p s
STEPSON	s t eh p s ah n
STEREO	s t eh r iy ow
STERNS	s t er n z
STETLER	s t eh t l er
STETSON	s t eh t s ah n
STEVEN	s t iy v ah n
STEWS	s t uw z
STIEG	s t iy g
STIENS	s t iy n z
STIFFEL	s t ih f ah l
STIFFS	s t ih f s
STIGERS	s t ay g er z
STILSON	s t ih l s ah n
STIMMEL	s t ih m ah l
STINE	s t ay n
STIRES	s t ay r z
STOCKER	s t aa k er
STOCUM	s t ow k ah m
STOEGER	s t ow g er
STOKE	s t ow k
STOKER	s t ow k er
STOKLEY	s t aa k l iy
STOLARZ	s t ow l aa r z
STOOGE	s t uw jh
STOOKEY	s t uw k iy
STOP	s t aa p
STOPA	s t ow p ah
STORCH	s t ao r k
STORIE	s t ao r iy
STOSSEL	s t aa s ah l
STOVES	s t ow v z
STOWER	s t ow er
STRADER	s t r ey d er
STRAFE	s t r ey f
STRANDE	s t r ae n d
STRAY	s t r ey
STREAKS	s t r iy k s
STREED	s t r iy d
STREETY	s t r iy t iy
STREFF	s t r eh f
STREIT	s t r ay t
STREY	s t r ey
STRIDE	s t r ay d
STRING	s t r ih ng
STRIPED	s t r ay p t
STROOP	s t r uw p
STRUNG	s t r ah ng
STUART	s t uw er t
STUBBS	s t ah b z
STUCKER	s t ah k er
STUCKY	s t ah k iy
STUD	s t ah d
STUDDS	s t ah d z
STUDENT	s t uw d ah n t
STUFF	s t ah f
STUFFS	s t ah f s
STUKA	s t uw k ah
STUKES	s t uw k s
STUMBO	s t ah m b ow
STUMPER	s t ah m p er
STUNNED	s t ah n d
STUNTS	s t ah n t s
STUNTZ	s t ah n t s
STURTZ	s t er t s
STURZA	s t er z ah
STYMIE	s t ay m iy
STYNE	s t ay n
SUAREZ	s w aa r eh z
SUASION	s w ey zh ah n
SUBROTO	s uw b r ow t ow
SUBZERO	s ah b z ih r ow
SUCKOW	s ah k aw
SUCKROW	s ah k r ow
SUCRE	s uw k er
SUDAN	s uw d ae n
SUDDUTH	s ah d ah th
SUEDE	s w ey d
SUISSE	s w ih s
SUITE	s w iy t
SUITORS	s uw t er z
SULEK	s uw l ih k
SULFIDE	s ah l f ay d
SULLENS	s ah l ah n z
SULLINS	s ah l ih n z
SULYA	s uw l y ah
SUMPTER	s ah m p t er
SUMS	s ah m z
SUNDAYS	s ah n d ey z
SUNDBY	s ah n d b iy
SUNDE	s ah n d
SUNLIT	s ah n l ih t
SUNSERI	s ah n s eh r iy
SUNTER	s ah n t er
SUPREME	s ah p r iy m
SURPLUS	s er p l ah s
SURRY	s er iy
SUSA	s uw s ah
SUSAN	s uw z ah n
SUSANA	s uw s aa n ah
SUSHI	s uw sh iy
SUSPEND	s ah s p eh n d
SUTCH	s ah ch
SUTFIN	s ah t f ih n
SUTO	s uw t ow
SUTPHEN	s ah t f ah n
SUTTER	s ah t er
SUTURED	s uw ch er d
SUZANNA	s uw z ae n ah
SVOBODA	s v ow b ow d ah
SWABY	s w aa b iy
SWADLEY	s w aa d l iy
SWAINE	s w ey n
SWANER	s w ao n er
SWANN'S	s w aa n z
SWANNER	s w aa n er
SWARTHY	s w ao r dh iy
SWATTED	s w aa t ih d
SWAYNE	s w ey n
SWEAT	s w eh t
SWEATED	s w eh t ih d
SWEATT	s w iy t
SWEAZY	s w iy z iy
SWECKER	s w eh k er
SWEERS	s w ih r z
SWEETIE	s w iy t iy
SWEPT	s w eh p t
SWERVE	s w er v
SWIECH	s w iy ch
SWIFT'S	s w ih f t s
SWIM	s w ih m
SWISTAK	s w ih s t ah k
SWOBODA	s w ow b ow d ah
SWORD	s ao r d
SWOYER	s w oy er
SWYERS	s w ay er z
SWYGERT	s w ih g er t
SYBERT	s ih b er t
SYDOW	s ih d ow
SYLVIE	s ih l v iy
SYLVIO	s ih l v iy ow
SYME	s ay m
SYMON	s ih m ah n
SYNCOR	s ih n k ao r
SYNDER	s ih n d er
SYNOVUS	s ah n ow v ah s
SYNTAX	s ih n t ae k s
SYRING	s ay r ih ng
SYRUPS	s er ah p s
SZABO	sh aa b ow
SZAREK	sh aa r eh k
SZE	sh iy
TABAKA	t aa b aa k ah
TABASCO	t ah b ae s k ow
TABITHA	t ae b ih th ah
TABOR	t ey b er
TAC	t ae k
TACIT	t ae s ih t
TACK	t ae k
TACKING	t ae k ih ng
TADA	t aa d ah
TADASHI	t aa d aa sh iy
TADDY	t ae d iy
TADYCH	t aa d ih hh
TAFEL	t ae f ah l
TAHER	t ey er
TAIL	t ey l
TAINT	t ey n t
TAJIK	t aa jh ih k
TAKATA	t aa k aa t ah
TAKE	t ey k
TAKEDA	t aa k ey d ah
TAKEI	t aa k ey
TAKEOUT	t ey k aw t
TAKES	t ey k s
TAKETH	t ey k ah th
TALE	t ey l
TALIBAN	t ae l ih b ae n
TALK'S	t ao k s
TALKIES	t ao k iy z
TALLENT	t aa l ah n t
TALLO	t ae l ow
TALON	t ae l ah n
TAMPA'S	t ae m p ah z
TANGE	t ae n jh
TANKED	t ae ng k t
TANSKI	t ae n s k iy
TANSY	t ae n z iy
TAOIST	d aw ih s t
TAPERS	t ey p er z
TAPES	t ey p s
TAPPE	t ae p
TARBOX	t aa r b aa k s
TARGETS	t aa r g ah t s
TARIN	t aa r iy n
TARSUS	t aa r s ah s
TART	t aa r t
TARTARS	t aa r t er z
TARTS	t aa r t s
TARTT	t aa r t
TASK	t ae s k
TASKER	t ae s k er
TASMAN	t ae z m ah n
TASTE	t ey s t
TASTERS	t ey s t er z
TATEHO	t ah t ey hh ow
TATER	t ey t er
TATIANA	t ae t iy ae n ah
TATLOCK	t ae t l aa k
TATTERS	t ae t er z
TATTOO	t ae t uw
TATTY	t ae t iy
TATYANA	t aa t y aa n ah
TAUBE	t ao b
TAUL	t ao l
TAUZIN	t aw z ih n
TAVANO	t aa v aa n ow
TAVARES	t aa v aa r eh s
TAVERN	t ae v er n
TAWANA	t aa w aa n ah
TAXED	t ae k s t
TAXER	t ae k s er
TAXERS	t ae k s er z
TAXI	t ae k s iy
TAXIS	t ae k s iy z
TAXIWAY	t ae k s iy w ey
TB	t iy b iy
TEA	t iy
TEACUP	t iy k ah p
TEALL	t iy l
TEASING	t iy z ih ng
TEASLEY	t iy z l iy
TEASON	t iy s ao n
TEBEAU	t ih b ow
TECHS	t eh k s
TECOS	t iy k ow s
TEDMAN	t eh d m ah n
TEELING	t iy l ih ng
TEENIE	t iy n iy
TEES	t iy z
TEET	t iy t
TEETH	t iy th
TEETHE	t iy dh
TEIKOKU	t ey k ow k uw
TEJANO	t ey y aa n ow
TEJEDA	t ey y ey d ah
TELEKOM	t eh l ah k aa m
TELFORD	t eh l f er d
TELL	t eh l
TELLES	t eh l z
TELLIER	t eh l iy er
TEMPEST	t eh m p ah s t
TEMPLAR	t eh m p l er
TEMPO	t eh m p ow
TENANT	t eh n ah n t
TENCZA	t eh n ch ah
TENDLER	t eh n d l er
TENDONS	t eh n d ah n z
TENDS	t eh n d z
TENOR	t eh n er
TENORIO	t eh n ao r iy ow
TENTHS	t eh n th s
TENTING	t eh n t ih ng
TER	t er
TERESE	t eh r iy z
TERESSA	t er eh s ah
TERKEL	t er k ah l
TERMEER	t er m ih r
TERMINE	t er m ih n
TERMINI	t er m ih n ay
TERRAL	t eh r ah l
TERRILL	t eh r ah l
TERRY	t eh r iy
TERZIAN	t er z iy ah n
TESCO	t eh s k ow
TESLER	t eh s ah l er
TESSIE	t eh s iy
TEST'S	t eh s t s
TESTERS	t eh s t er z
TESTES	t eh s t iy z
TESTIFY	t eh s t ah f ay
TESTING	t eh s t ih ng
TESTS'	t eh s t s
TETLEY	t eh t l iy
TETLOW	t eh t l ow
TETRICK	t eh t r ih k
TETSUJI	t eh t s uw jh iy
TEVA	t ey v ah
TEVLIN	t eh v l ih n
TEW	ch uw
TEXAS'	t eh k s ah s ih z
TEZENO	t ey z ey n ow
TH	t iy ey ch
THADEN	th ey d ah n
THAIN	th ey n
THANO	th aa n ow
THAR	th aa r
THAWING	th ao ih ng
THEANO	th iy n ow
THEREBY	dh eh r b ay
THERIEN	th ih r iy n
THERMCO	th er m k ow
THESES	th iy s iy z
THESING	dh iy z ih ng
THEURER	th er er
THEW	th uw
THEY	dh ey
THEY'LL	dh ey l
THICKEN	th ih k ah n
THIGPEN	th ih g p ah n
THING	th ih ng
THING'S	th ih ng z
THIRSTY	th er s t iy
THIRZA	th er z ah
THISTLE	th ih s ah l
THODE	th ow d
THOMURE	th aa m y uw r
THOREAU	th er ow
THORNE	th ao r n
THORNER	th ao r n er
THORSEN	th ao r s ah n
THORSON	th ao r s ah n
THRICE	th r ay s
THROWER	th r ow er
THUG	th ah g
THUGS	th ah g z
THUL	th ah l
THULIN	th uw l ih n
THUMBED	th ah m d
THUMP	th ah m p
THURMAN	th er m ah n
THURMON	th er m ah n
THURNAU	th er n ow
THUROW	th uh r ow
THWING	th w ih ng
TIBBY	t ih b iy
TIC	t ih k
TICINUS	t ih s iy n ah s
TICKNER	t ih k n er
TICOR	t ay k ao r
TIE	t ay
TIEGS	t iy g z
TIEING	t ay ih ng
TIERED	t iy r d
TIERNAN	t ih r n ah n
TIETZ	t iy t s
TIFFIN	t ih f ih n
TIGAR'S	t ay g aa r z
TILL	t ih l
TILLIS	t ih l ih s
TILLMON	t ih l m ah n
TILLSON	t ih l s ah n
TIMMENY	t ih m ah n iy
TIMMINS	t ih m ih n z
TINCH	t ih n ch
TINDEL	t ih n d ah l
TINE	t ay n
TINGLE	t ih ng g ah l
TINGLER	t ih ng g ah l er
TINKER	t ih ng k er
TINMAN	t ih n m ae n
TINNEY	t ih n iy
TINO	t iy n ow
TINT	t ih n t
TINY	t ay n iy
TIPA	t ih p ah
TIPPENS	t ih p ah n z
TIPPETS	t ih p ih t s
TIPPING	t ih p ih ng
TIPPLE	t ih p ah l
TIRADES	t ay r ey d z
TIRADO	t ih r aa d ow
TIRE	t ay er
TISDEL	t ih s d ah l
TISSUE	t ih s y uw
TITHING	t ay dh ih ng
TITINUS	t ih t ah n ah s
TOAL	t ow l
TODAYS	t ah d ey z
TODT	t aa d t
TOEHOLD	t ow hh ow l d
TOFT	t aa f t
TOFTE	t ow f t
TOGGLED	t aa g ah l d
TOILET	t oy l ah t
TOLLETT	t aa l ih t
TOMATOS	t ah m ey t ow z
TOMCZYK	t aa m ch ih k
TOMPANE	t aa m p ey n
TONG	t ao ng
TONIE	t ow n iy
TONK	t ao ng k
TONKA	t aa ng k ah
TONTON	t aa n t ah n
TONYSK	t ow n iy s k
TOO	t uw
TOOHEY	t uw iy
TOOLEY	t uw l iy
TOOMER	t uw m er
TOOT	t uw t
TOOTHED	t uw th t
TOOTLE	t uw t ah l
TOPE	t ow p
TOPETE	t aa p iy t
TOPHAM	t aa f ah m
TOPIARY	t ow p iy eh r iy
TOPICAL	t aa p ah k ah l
TOPKNOT	t aa p n aa t
TOPPING	t aa p ih ng
TOPPINS	t aa p ih n z
TORELLO	t ao r eh l ow
TOREY	t ao r iy
TORLEY	t ao r l iy
TORME	t ao r m
TORRENT	t ao r ah n t
TORREY	t ao r iy
TORTE	t ao r t
TORTI	t ao r t iy
TORTORA	t ao r t ao r ah
TOSCA	t ao s k ah
TOSCO	t ao s k ow
TOSO	t ow s ow
TOTALLY	t ow t ah l iy
TOTO	t ow t ow
TOTTEN	t aa t ah n
TOUGHER	t ah f er
TOUR	t uh r
TOUTANT	t uw t ao n t
TOUTING	t aw t ih ng
TOWER	t aw er
TOWNSEL	t aw n s ah l
TOWS	t ow z
TOXICS	t aa k s ih k s
TOYO	t ow y ow
TOYOTAS	t oy ow t ah z
TRABER	t r ey b er
TRACES	t r ey s ah z
TRACIE	t r ey s iy
TRACK	t r ae k
TRACZ	t r aa ch
TRAK	t r ae k
TRAMPE	t r ae m p
TRAMPLE	t r ae m p ah l
TRANSCO	t r ae n s k ow
TRAPP	t r ae p
TRAUM	t r ao m
TRAVERS	t r ae v er z
TRAWICK	t r ao ih k
TRE	t r ey
TREBLE	t r eh b ah l
TREETOP	t r iy t ao p
TREMOR	t r eh m er
TRESCH	t r eh sh
TRESSES	t r eh s ih z
TREW	t r uw
TREZZA	t r eh z ah
TRIAGE	t r ay ih jh
TRIBASA	t r ay b ae s ah
TRIBBY	t r ih b iy
TRIBES	t r ay b z
TRICHET	t r ih ch ih t
TRICIA	t r ih sh ah
TRICKLE	t r ih k ah l
TRIEU	t r uw
TRIFARI	t r ih f aa r iy
TRIG	t r ih g
TRINKLE	t r ih ng k ah l
TRIO'S	t r iy ow z
TRIP'S	t r ih p s
TRIPI	t r iy p iy
TRIPOLI	t r ih p ah l iy
TRIPP	t r ih p
TRISKA	t r ih s k ah
TRISTAR	t r ay s t aa r
TRITE	t r ay t
TRIUMPH	t r ay ah m f
TRIVEDI	t r iy v eh d iy
TRIVIAL	t r ih v iy ah l
TROCKI	t r aa k iy
TROIA	t r ow y ah
TROIANO	t r ow iy aa n ow
TROISE	t r oy z
TROISI	t r oy s iy
TROJAN	t r ow jh ah n
TROJANS	t r ow jh ah n z
TROKEL	t r ow k ah l
TRON	t r aa n
TROOPS'	t r uw p s
TROTH	t r ow th
TROUNCE	t r aw n s
TROUT	t r aw t
TROXLER	t r aa k s l er
TRUCK'S	t r ah k s
TRUCKED	t r ah k t
TRUDEL	t r uw d ah l
TRUDO	t r uw d ow
TRUDY	t r uw d iy
TRUMKA	t r ah m k ah
TRUMPS	t r ah m p s
TRUONG	t r ao ng
TRUSTCO	t r ah s t k ow
TRY-ONS	t r ay aa n z
TRYGG	t r ih g
TRYST	t r ih s t
TS	t iy eh s
TSANG	t s ae ng
TSU	t s uw
TUBBS	t ah b z
TUBE	t uw b
TUBES	t uw b z
TUBMAN	t ah b m ah n
TUBULE	t uw b y uw l
TUFTE	t ah f t
TUGGING	t ah g ih ng
TULL	t ah l
TULLAR	t ah l er
TUMEY	t ah m iy
TUMMOND	t ah m ah n d
TUMOR	t uw m er
TUNED	t uw n d
TUNGATE	t uw ng ey t
TUNIS	t uw n ih s
TUPAC	t uw p ao k
TURANO	t uh r aa n ow
TURBEN	t er b ah n
TURBOS	t er b ow z
TURI	t uh r iy
TURISMO	t uh r ih s m ow
TURKEL	t er k ah l
TURKEY	t er k iy
TURNAGE	t er n ih jh
TURNING	t er n ih ng
TURRETS	t er ah t s
TURSI	t uh r s iy
TURTLES	t er t ah l z
TUSSLED	t ah s ah l d
TUTORS	t uw t er z
TUTSI'S	t uw t s iy z
TUXFORD	t ah k s f er d
TWAROG	t w ao r ao g
TWEDT	t w eh d t
TWELVTH	t w eh l v th
TWICE	t w ay s
TWIFORD	t w ih f er d
TWIN	t w ih n
TWINJET	t w ih n jh eh t
TWINS'	t w ih n z
TWIRL	t w er l
TWISTY	t w ih s t iy
TWYMAN	t w ay m ah n
TY	t ay
TYCOON	t ay k uw n
TYLER'S	t ay l er z
TYPICAL	t ih p ah k ah l
U.	y uw
UCCEL	uw ch ah l
UCCI	uw ch iy
UDOLF	ah d ow l f
UEDA	w eh d ah
UGARTE	uw g aa r t iy
UHLICH	uw l ih k
UHRIN	uh r ih n
ULCER	ah l s er
ULFRED	ah l f er d
ULITSA	y uw l ih t s ah
ULLOA	uw l ow ah
ULRICK	ah l r ih k
UMLAUF	ah m l aw f
UMM	ah m
UMMEL	ah m ah l
UMPHREY	ah m f r iy
UNCORK	ah n k ao r k
UND	ah n d
UNDER	ah n d er
UNDULY	ah n d uw l iy
UNEASE	ah n iy z
UNEASY	ah n iy z iy
UNFOLD	ah n f ow l d
UNGLUED	ah n g l uw d
UNHAPPY	ah n hh ae p iy
UNHEARD	ah n hh er d
UNHINGE	ah n hh ih n jh
UNIKOM	y uw n ih k ao m
UNIT	y uw n ah t
UNITRIN	y uw n ih t r ih n
UNIX	y uw n ih k s
UNLOVED	ah n l ah v d
UNMADE	ah n m ey d
UNRUH	ah n r uw
UNSCOM	ah n s k ao m
UNSOUND	ah n s aw n d
UNSUNG	ah n s ah ng
UNTED	ah n t eh d
UNTIE	ah n t ay
UNTOLD	ah n t ow l d
UNUSUAL	ah n y uw zh uw ah l
UNVEIL	ah n v ey l
UNVEILS	ah n v ey l z
UPHOLDS	ah p hh ow l d z
UPJOHN	ah p jh aa n
UPLIFT	ah p l ih f t
UPSET	ah p s eh t
UPSIDE	ah p s ay d
UPSTART	ah p s t aa r t
UPTIGHT	ah p t ay t
UPTON	ah p t ah n
UPWOOD	ah p w uh d
URBAN'S	er b ah n z
URBANI	er b aa n iy
URDU	er d uw
URGENCY	er jh ah n s iy
URI	y er iy
URREA	er iy ah
URSOLA	er s ow l ah
URSUS	er s ah s
USA	y uw eh s ey
USEFUL	y uw s f ah l
USER	y uw z er
USERS	y uw z er z
USHERS	ah sh er z
USONIAM	y uw s ow n iy ah m
UTERUS	y uw t er ah s
UTHE	ah dh
UTILIZE	y uw t ah l ay z
UTTERS	ah t er z
UYEHARA	uw y ey hh aa r ah
UYENO	ay ey n ow
UZZELL	uw z eh l
V.S	v iy z
VACA	v ae k ah
VACCINE	v ae k s iy n
VACUUM	v ae k y uw m
VADAS	v aa d aa z
VAINLY	v ey n l iy
VAJDA	v ay d ah
VALENZA	v ah l eh n z ah
VALESKA	v aa l ey s k ah
VALET	v ae l ey
VALIUM	v ey l iy ah m
VALKO	v ae l k ow
VALLEYS	v ae l iy z
VALLS	v ao l z
VALOIS	v ae l w aa
VALSPAR	v ae l z p aa r
VALUES'	v ae l y uw z
VALVE	v ae l v
VAMOS	v aa m ow z
VANAMAN	v ae n ao m ah n
VANDYK	v ae n d ih k
VANHORN	v ae n hh ao r n
VANHOVE	v ae n hh ah v
VANHOY	v ae n hh oy
VANHUSS	v ae n hh ah s
VANLIEW	v ae n l iy uw
VANLOO	v ae n l uw
VANNIE	v ae n iy
VANOSS	v ae n aa s
VANOVER	v ae n ow v er
VANS	v ae n z
VANSCOY	v ae n s k oy
VANUNU	v ah n uw n uw
VANWIE	v ae n w iy
VAPID	v ae p ih d
VARIANT	v eh r iy ah n t
VARNES	v aa r n z
VARNUM	v aa r n ah m
VARON	v aa r ao n
VASE	v ey s
VASILY	v ae s ah l iy
VASQUES	v aa s k w eh s
VATS	v ae t s
VAUGH	v ao
VAULT	v ao l t
VAUPEL	v aw p eh l
VAVREK	v aa v r eh k
VAZQUEZ	v ae s k eh z
VE	v iy
VEACH	v iy ch
VEASEY	v iy z iy
VECCHIO	v eh k iy ow
VECTORS	v eh k t er z
VEECH	v iy ch
VEERED	v ih r d
VEES	v iy z
VEGAN	v eh g ah n
VEGETAL	v eh jh ah t ah l
VEINS	v ey n z
VEIRA	v ey r ah
VELMA	v eh l m ah
VELTEN	v eh l t ah n
VENA	v iy n ah
VENANGO	v eh n ae ng g ow
VENDEE	v eh n d iy
VENEER	v ah n ih r
VENICE	v eh n ah s
VENT	v eh n t
VER	v er
VERDON	v eh r d ao n
VERDUIN	v eh r d uw ih n
VEREEN	v ih r iy n
VERES	v iy r z
VERMA	v eh r m ah
VERMONT	v er m aa n t
VERN	v er n
VERRALL	v eh r ah l
VERRY	v eh r iy
VERTOL	v er t aa l
VERWEY	v er w iy
VERY	v eh r iy
VEST	v eh s t
VESTA	v eh s t ah
VESTIGE	v eh s t ih jh
VETOED	v iy t ow d
VETOS	v iy t ow z
VEVERKA	v ey v eh r k ah
VI	v ay
VIABLE	v ay ah b ah l
VIALL	v ay ah l
VIANSA	v iy aa n s ah
VICAR	v ih k er
VICENZI	v ih s eh n z iy
VIDAL	v ay d ae l
VIEAU	v iy ow
VIETOR	v iy t er
VIGEN	v ih g ah n
VIGER	v ay g er
VILAS	v iy l aa z
VIN	v ih n
VINCENT	v ih n s ah n t
VINEGAR	v ih n ah g er
VINER	v ay n er
VINET	v ih n ih t
VINI	v iy n iy
VINT	v ih n t
VINYL	v ay n ah l
VIRINA	v ih r iy n ah
VIRKLER	v er k ah l er
VIRTUES	v er ch uw z
VIRUS	v ay r ah s
VISCO	v iy s k ow
VISHAY	v ih sh ey
VISTAS	v ih s t ah z
VITALE	v ih t ae l iy
VITALI	v iy t aa l iy
VIV	v ih v
VIVENDI	v ih v eh n d iy
VIVIAN	v ih v iy ah n
VIVIE	v ih v iy
VIVO	v iy v ow
VIVRA	v iy v r ah
VIZZINI	v iy t s iy n iy
VLACHOS	v l ey k ow s
VLAD'S	v l ae d z
VLASAK	v l aa s ah k
VLIET	v l iy t
VOELKEL	v ow l k ah l
VOELL	v ow l
VOELLER	v ow l er
VOGE	v ow jh
VOGELS	v ow g ah l z
VOICE'S	v oy s ih z
VOIDED	v oy d ih d
VOIDS	v oy d z
VOISEY	v w aa s ey
VOLKERS	v ow l k er z
VOLMER	v ow l m er
VOLUMES	v aa l y uw m z
VONA	v ow n ah
VONNY	v aa n iy
VONS'S	v aa n z ih z
VOORHIS	v uh r hh ih s
VOSS	v ao s
VOTAVA	v ow t aa v ah
VOTES	v ow t s
VOTRUBA	v ah t r uw b ah
VOW	v aw
VOWELL	v aa w eh l
VOWS	v aw z
VOYAGES	v oy ah jh ah z
VOYLES	v oy l z
VOYTEK	v oy t ih k
VRANOS	v r aa n ow s
VUOLO	v uw ow l ow
WAAG	w aa g
WAARA	w aa r ah
WACHS	w ao k s
WADDIE	w aa d iy
WADE'S	w ey d z
WAFFLE	w aa f ah l
WAGMAN	w ae g m ah n
WAGNER	w ae g n er
WAISTS	w ey s t s
WAITED	w ey t ah d
WAITS	w ey t s
WAKEHAM	w ae k ah m
WAKLEY	w ae k l iy
WALCZAK	v aa l ch ae k
WALCZYK	v aa l ch ih k
WALDA	v aa l d ah
WALDEN	w ao l d ah n
WALDORF	w ao l d ao r f
WALDRIP	w ao l d r ah p
WALDROP	w ao l d r aa p
WALFRED	w ao l f r eh d
WALKLEY	w ao k l iy
WALKOUT	w ao k aw t
WALLABY	w aa l ah b iy
WALLACH	w ao l ah k
WALLACK	w ao l ah k
WALLE	w ao l
WALLIE	w ao l iy
WALLO	w aa l ow
WALLOP	w aa l ah p
WALLOW	w aa l ow
WALLY	w ao l iy
WALNUT	w ao l n ah t
WALP	w ae l p
WALRATH	w ao l r ah th
WALRUS	w ao l r ah s
WALSER	w ao l z er
WALSKI	v aa l s k iy
WALTONS	w ao l t ah n z
WALTZES	w ao l t s ah z
WAMBOLT	w aa m b ow l t
WANG'S	w ae ng z
WANGER	w ae ng er
WANLESS	w aa n l ah s
WANN	w aa n
WANTA	w aa n t ah
WANTED	w aa n t ah d
WANTZ	w aa n t s
WAPNER	w aa p n er
WARD'S	w ao r d z
WARDEN	w ao r d ah n
WAREING	w eh r ih ng
WARGO	w ao r g ow
WARLIKE	w ao r l ay k
WARLING	w ao r l ih ng
WARLORD	w ao r l ao r d
WARMER	w ao r m er
WARMING	w ao r m ih ng
WARPATH	w ao r p ae th
WARREN	w ao r ah n
WARS	w ao r z
WARTMAN	w ao r t m ah n
WASATCH	w aa s ae ch
WASEDA	w ah s iy d ah
WASHER	w aa sh er
WASHERS	w aa sh er z
WASHING	w aa sh ih ng
WASSILY	v ah s ih l iy
WATCH	w aa ch
WATCHED	w aa ch t
WATER	w ao t er
WATERED	w ao t er d
WATT'S	w aa t s
WAVER	w ey v er
WAX	w ae k s
WAYLAID	w ey l ey d
WAYNICK	w ey n ih k
WAZIR'S	w aa z ih r z
WEAKENS	w iy k ah n z
WEANED	w iy n d
WEARER	w eh r er
WEBBER	w eh b er
WEBER	w eh b er
WEBS	w eh b z
WECHT	w eh k t
WEEDMAN	w iy d m ah n
WEERTS	w ih r t s
WEESE	w iy z
WEGER	w iy g er
WEHLER	w eh l er
WEHRLY	w eh r l iy
WEI	w ey
WEICHT	w ay k t
WEIDIG	w ay d ih g
WEIGELT	w ay g ih l t
WEIGHT	w ey t
WEIMAN	w ay m ah n
WEITZEL	w ay t z ah l
WELBY	w eh l b iy
WELCH'S	w eh l ch ih z
WELDEN	w eh l d ah n
WELDON	w eh l d ah n
WELFORD	w eh l f er d
WELL	w eh l
WELLAND	w eh l ah n d
WELLING	w eh l ih ng
WELSH	w eh l ch
WELTY	w eh l t iy
WENDER	w eh n d er
WENDERS	w eh n d er z
WENDING	w eh n d ih ng
WENG	w eh ng
WENRICH	w eh n r ih k
WENT	w eh n t
WENZ	w eh n z
WENZL	w eh n z ah l
WENZLER	w eh n z l er
WEPT	w eh p t
WERDER	w er d er
WERGIN	w er g ih n
WERNE	w er n ah
WERNICK	w er n ih k
WERST	w er s t
WERTMAN	w er t m ah n
WESCO	w eh s k ow
WESLER	w eh s ah l er
WESSON	w eh s ah n
WESTECH	w eh s t eh k
WESTEN	w eh s t ah n
WESTON	w eh s t ah n
WET	w eh t
WEYER	w ey er
WEYL	w ey l
WHACKS	w ae k s
WHALERS	w ey l er z
WHARF	w ao r f
WHAT	w ah t
WHAT'LL	w ah t ah l
WHEDON	w eh d ah n
WHICH	w ih ch
WHIPSAW	w ih p s ao
WHISTON	w ih s t ah n
WHITE'S	w ay t s
WHITLEY	w ih t l iy
WHITNER	w ih t n er
WHITTY	w ih t iy
WHORE	hh ao r
WHORLEY	hh ao r l iy
WIBERG	w ay b er g
WICAT	w ih k ae t
WICE	w ay s
WICKENS	w ih k ah n z
WICKER	w ih k er
WICKS	w ih k s
WIDE'S	w ay d z
WIDEN	w ay d ah n
WIDICK	w ih d ih k
WIDING	w ay d ih ng
WIDMAR	w ih d m er
WIDRICK	w ih d r ih k
WIDTH	w ih d th
WIEAND	w iy ah n d
WIEBE	w iy b
WIELAND	w iy l ah n d
WIENER	w iy n er
WIERZBA	v ih r z b ah
WIES	w ay z
WIESEL	w iy s ah l
WIESNER	w iy z n er
WIEST	w ay ih s t
WIGAL	w ih g ah l
WIGGS	w ih g z
WILBUR	w ih l b er
WILDLY	w ay l d l iy
WILDS	w ay l d z
WILEEN	w ih l iy n
WILEMON	w ih l ih m aa n
WILES	w ay l z
WILEY	w ay l iy
WILFORD	w ih l f er d
WILHOIT	w ih l hh oy t
WILKE	w ih l k
WILKENS	w ih l k ah n z
WILLAM	w ih l ah m
WILLEN	w ih l ah n
WILLES	w ay l z
WILLET	w ih l ih t
WILLETT	w ih l ih t
WILLIE	w ih l iy
WILLIG	w ih l ih g
WILLMON	w ih l m ah n
WILLOW	w ih l ow
WILMAR	w ih l m er
WILMOT	w ih l m ah t
WILMUT	w ih l m ah t
WILPON	w ih l p aa n
WILTHEW	w ih l th y uw
WIMAN	w ay m ah n
WIMPY	w ih m p iy
WINBORN	w ih n b er n
WINBURN	w ih n b er n
WINCE	w ih n s
WINCING	w ih n s ih ng
WINDERS	w ih n d er z
WINDOM	w ih n d ah m
WINDUP	w ay n d ah p
WINER	w ay n er
WINES	w ay n z
WINFREE	w ih n f r iy
WING	w ih ng
WINKER	w ih ng k er
WINKLE	w ih ng k ah l
WINN	w ih n
WINNE	w ih n
WINNER	w ih n er
WINNY	w ih n iy
WINSTON	w ih n s t ah n
WINTON	w ih n t ah n
WINWOOD	w ih n w uh d
WINWORD	w ih n w er d
WINZER	w ih n z er
WION	w ay ah n
WIPES	w ay p s
WIPF	w ih p f
WIRETAP	w ay er t ae p
WISHNER	w ih sh n er
WISHY	w ih sh iy
WISS	w ih s
WISSING	w ih s ih ng
WIT	w ih t
WITCHER	w ih ch er
WITHROW	w ih th r ow
WITS	w ih t s
WITTING	w ih t ih ng
WITTMAN	w ih t m ah n
WITZ	w ih t s
WITZEL	w ih t z ah l
WIZ	w ih z
WM	w ih l y ah m
WOBBLED	w aa b ah l d
WOELFEL	w ow l f ah l
WOGAN	w ow g ah n
WOJDYLA	w oy d ih l ah
WOKE	w ow k
WOKEN	w ow k ah n
WOLAK	w ow l ah k
WOLFE'S	w uh l f s
WOLMAN	w aa l m ah n
WOLPERT	w ow l p er t
WOMBAT	w aa m b ae t
WOMBLE	w aa m b ah l
WONDER	w ah n d er
WONK	w aa n k
WOO'S	w uw z
WOOD'S	w uh d z
WOODSON	w uh d s ah n
WOOFTER	w uw f t er
WOOLEN	w uh l ah n
WOOLF	w uh l f
WOOLLY	w uh l iy
WOOLY	w uh l iy
WOOSLEY	w uw z l iy
WOOTAN	w uw t ah n
WORDY	w er d iy
WORK	w er k
WORKMEN	w er k m ih n
WORLD'S	w er l d z
WORRALL	w er r ah l
WORRIES	w er iy z
WORSEN	w er s ah n
WORST	w er s t
WORSTED	w er s t ih d
WORTH	w er th
WORTH'S	w er th s
WOULD	w uh d
WRAP	r ae p
WRENN	r eh n
WRICE	r ay s
WRIGHT	r ay t
WRITER	r ay t er
WRONG	r ao ng
WRYLY	r ay l iy
WUENSCH	w uh n sh
WUXI	w ah k s iy
WY	w ey
WYANT	w ay ah n t
WYKES	w ay k s
WYLAND	w ay l ah n d
WYLER	w ay l er
WYLES	w ay l z
WYNONA	w ay n ow n ah
WYNTON	w ih n t ah n
WYSE'S	w ay z ih z
XENIA	z iy n iy ah
XENON	z iy n aa n
XEROX	z ih r aa k s
XIDEX	z ih d ah k s
XSCRIBE	eh k s k r ay b
XUDONG	z uw d ao ng
Y	w ay
YACHTER	y aa t er
YACKLEY	y ae k l iy
YADDA	y aa d ah
YAHR	y aa r
YAMANE	y aa m aa n ey
YAMIN	y ae m ih n
YAN	y ae n
YANBU	y ae n b uw
YANKEY	y ae ng k iy
YANKO	y ae ng k ow
YANNICK	y ae n ih k
YAPP	y ae p
YARDAGE	y aa r d ih jh
YARGER	y aa r jh er
YASTROW	y ae s t r ow
YATES	y ey t s
YAU	y ow
YAX	y ae k s
YEAGER	y ey g er
YEAR	y ih r
YEAS	y ey z
YEATTS	y iy t s
YEE	y iy
YEHLE	y eh hh ah l
YEHUDI	y ey hh uw d iy
YELLIN	y eh l ih n
YELLING	y eh l ih ng
YEMEN'S	y eh m ah n z
YEN	y eh n
YERGIN	y er g ah n
YERKEY	y er k iy
YETTA	y eh t ah
YIKES	y ay k s
YIN	y ih n
YOCAM	y ow k ah m
YOGA	y ow g ah
YOHO	y ow hh ow
YOLA	y ow l ah
YONAN	y ow n ah n
YOOR	y uw r
YOOR'S	y uw r z
YORDY	y ao r d iy
YORKERS	y ao r k er z
YOSHINO	y ow sh iy n ow
YOU'LL	y uw l
YOU'VE	y uw v
YOUGHAL	y ow ah l
YOUMANS	y uw m ah n z
YOUNGER	y ah ng g er
YOURI	y uh r iy
YOUSIF	y aw s ih f
YSLETA	iy s l ey t ah
YTTRIUM	ih t r iy ah m
YUCCA	y ah k ah
YUGOS	y uw g ow s
YUKS	y ah k s
YUM	y ah m
YUMMIES	y ah m iy z
YUNDE	y uw n d ey
YUNICH	y uw n ih ch
YUSTEF	y uw s t eh f
YUTAKA	y uw t aa k ah
Z	z iy
ZACCARO	z aa k aa r ow
ZACHOW	z aa k ow
ZACKS	z ae k s
ZAGAT	z ae g ah t
ZAHNER	z aa n er
ZAINO	z ey n ow
ZAIRE'S	z ay ih r z
ZAIRIAN	z ay ih r iy ah n
ZAITSEV	z ey t s eh v
ZAMBIA	z ae m b iy ah
ZAMMIT	z ae m ih t
ZAMUDIO	z aa m uw d iy ow
ZANDER	z ae n d er
ZANDY'S	z ae n d iy z
ZANE	z ey n
ZANETA	z aa n eh t ah
ZANONI	z aa n ow n iy
ZANUCK	z ae n ah k
ZARA	z ae r ah
ZARATE	z aa r ey t
ZASLOW	z aa s l ow
ZEAL	z iy l
ZEBRA	z iy b r ah
ZEBRAS	z iy b r ah z
ZEHNER	z eh n er
ZEIGER	z ay g er
ZEIS	z iy z
ZEITZ	z iy t s
ZEKE	z iy k
ZELENAK	z eh l ih n ah k
ZELIA	z eh l iy ah
ZELINKA	z ih l ih ng k ah
ZELKO	z eh l k ow
ZELLNER	z eh l n er
ZELMAN	z eh l m ah n
ZENDER	z eh n d er
ZENITH	z iy n ah th
ZENON	z iy n ah n
ZEOS	z iy ow s
ZERBY	z ih r b iy
ZEST	z eh s t
ZEVA	z ey v ah
ZHAMBU	z aa m b uw
ZIA'S	z iy ah z
ZIEBA	z iy b ah
ZIEG	z iy g
ZIEHM	z iy m
ZIELKE	z iy l k
ZIENTEK	z iy n t ih k
ZIERKE	z iy r k
ZIESMER	z iy s ah m er
ZIFF	z ih f
ZIKE	z ay k
ZILCH	z ih l ch
ZIMMER	z ih m er
ZINCK	z ih ng k
ZINDA	z ih n d ah
ZING	z ih ng
ZINNI	z ih n iy
ZINS	z ih n z
ZIONS	z ay ah n z
ZIPKIN	z ih p k ih n
ZIPPED	z ih p t
ZIRBEL	z er b ah l
ZIRBES	z er b z
ZIRCON	z er k ah n
ZISES	z ay z ih z
ZITHER	z ih dh er
ZITHERS	z ih dh er z
ZITO	z iy t ow
ZITTEL	z ih t ah l
ZLATA'S	z l aa t ah z
ZLOTYS	z l ao t iy z
ZOBEL	z ow b ah l
ZOLMAN	z aa l m ah n
ZOLP	z ow l p
ZOMBIES	z aa m b iy z
ZONES	z ow n z
ZOO'S	z uw z
ZOOK	z uh k
ZOOS	z uw z
ZORAH	z ao r ah
ZORNES	z ao r n z
ZORZI	z ao r z iy
ZOSEN	z ow z ah n
ZOUNDS	z aw n d z
ZSCHAU	zh aw
ZUBIA	z uw b iy ah
ZUBIN	z uw b ih n
ZUBROD	z ah b r ah d
ZUG'S	z ah g z
ZUGANOV	z uw g ah n ao v
ZUKER	z uw k er
ZULLO	z uw l ow
ZUMWALT	z ah m w ah l t
ZUNIGA	z uw n iy g ah
ZUPKO	z ah p k ow
ZVORNIK	z v ao r n ih k
ZWIEBEL	z w iy b ah l
ZYCH	z ay ch
ZYLSTRA	z ih l s t r ah
ZYSK	z ay s k
