A.S	ey z
A42128	ey f ao r t uw w ah n t uw ey t
AALSETH	aa l s eh th
AAMODT	aa m ah t
AARONS	eh r ah n z
ABADI	ah b ae d iy
ABANTO	ah b ae n t ow
ABBEY'S	ae b iy z
ABDELLA	ae b d eh l ah
ABLEST	ey b ah l s t
ABLY	ey b l iy
ABOARD	ah b ao r d
ABORTS	ah b ao r t s
ABOUD	aa b uw d
ABOUNDS	ah b aw n d z
ABRAM'S	ey b r ah m z
ABRAXAS	ah b r ae k s ah z
ABREAST	ah b r eh s t
ABREU	ah b r uw
ABRON	ah b r aa n
ABSCOND	ae b s k aa n d
ABSOLUT	ae b s ah l uw t
ABUSERS	ah b y uw z er z
ABUSIVE	ah b y uw s ih v
ABZUG	ae b z ah g
AC	ey s iy
ACCARDI	aa k aa r d iy
ACCEDED	ae k s iy d ih d
ACCENTS	ae k s eh n t s
ACCOST	ah k ao s t
ACCRUES	ah k r uw z
ACCURSO	aa k uh r s ow
ACE	ey s
ACECOMM	ey s k aa m
ACER	ey s er
ACIDITY	ah s ih d ah t iy
ACMAT	ae k m ae t
ACROBAT	ae k r ah b ae t
ACTION	ae k sh ah n
ACTIVE	ae k t ih v
ACTON	ae k t ah n
ACTUATE	ae k ch uw ey t
ACUMEN	ah k y uw m ah n
ADAGIO	ah d aa zh iy ow
ADAMES	ah d ey m z
ADAMO	aa d aa m ow
ADAMS'S	ae d ah m z ih z
ADAPTER	ah d ae p t er
ADARAND	ae d ah r ae n d
ADCOCK	ah d k aa k
ADDED	ae d ah d
ADDER	ae d er
ADDIE	ae d iy
ADDUCT	ae d ah k t
ADELL	ah d eh l
ADELSON	ae d ah l s ah n
ADER	ey d er
ADID	ah d ih d
ADLERS	ae d l er z
ADLONG	ae d l ao ng
ADMIRES	ae d m ay r z
ADO	ah d uw
ADOBE'S	ah d ow b iy z
ADOLFO	ah d aa l f ow
ADOPTED	ah d aa p t ah d
ADOREES	ae d er iy z
ADORNA	aa d ao r n ah
ADRAGNA	aa d r aa g n ah
ADVANCE	ah d v ae n s
ADVEST	ae d v eh s t
ADVISES	ae d v ay z ih z
AE	ey
AFFIX	ae f ih k s
AFGHAN	ae f g ae n
AFGHANI	ae f g aa n iy
AFLOAT	ah f l ow t
AGATHA	ae g ah th ah
AGE'S	ey jh ih z
AGELESS	ey jh l ah s
AGENT	ey jh ah n t
AGER	ey jh er
AGERS	ey jh er z
AGILDO	ah g ih l d ow
AGILE	ae jh ah l
AGNETA	aa g n eh t ah
AGNEW	ae g n uw
AGONY	ae g ah n iy
AGREES	ah g r iy z
AGRICO	ah g r iy k ow
AGUA	aa g w ah
AGUILAR	ae g ah l aa r
AGUILO	ah g w iy l ow
AHEARN	ah hh er n
AHERIN	aa er ih n
AHLGREN	aa l g r eh n
AHRENDT	aa r ih n t
AHUJA	aa hh uw y ah
AID	ey d
AIDE'S	ey d z
AIDED	ey d ah d
AIDING	ey d ih ng
AIESHA	ay sh ah
AIKMAN	ey k m ah n
AIKOFF	ay k ao f
AINSLEY	ey n s l iy
AIRBAGS	eh r b ae g z
AIRLESS	eh r l ah s
AIRPORT	eh r p ao r t
AIRTRAN	eh r t r ae n
AIRWAVE	eh r w ey v
AIST	ey s t
AITHNE	ey th n
AKER	ae k er
AKIBA	ah k iy b ah
AKINS	ah k ih n z
AKSAMIT	ae k s ah m ih t
AKZO'S	ae k z ow z
ALABAMA	ae l ah b ae m ah
ALAM	ah l ae m
ALAMEIN	ae l ah m ey n
ALAN	ae l ah n
ALANCO	ah l ae n k ow
ALARIC	ae l er ih k
ALARICA	aa l aa r iy k ah
ALARM'S	ah l aa r m z
ALASKA	ah l ae s k ah
ALASKAN	ah l ae s k ah n
ALBAUGH	ah l b ao
ALBERTY	ah l b er t iy
ALBUNEX	ae l b y uw n eh k s
ALCAN'S	ae l k ae n z
ALCATEL	ae l k ah t eh l
ALCOA'S	ae l k ow ah z
ALCOCK	ah l k aa k
ALDEN	aa l d ah n
ALDER	ao l d er
ALDILA	ae l d ih l ah
ALEWINE	ey l w ay n
ALEX'S	ae l ah k s ih z
ALEXI'S	ah l eh k s iy z
ALEXIS	ah l eh k s ih s
ALFA	ae l f ah
ALFALFA	ae l f ae l f ah
ALFIE	ae l f iy
ALGATA	ae l g aa t ah
ALGOL	ae l g aa l
ALGOM	ae l g ah m
ALGY	ae l jh iy
ALIANZA	ae l iy ae n z ah
ALIG	ae l ih g
ALIKE	ah l ay k
ALINES	ah l ay n z
ALISSA	ah l ih s ah
ALKIRE	ah l k ay r
ALLEN	ae l ah n
ALLERGY	ae l er jh iy
ALLERS	ao l er z
ALLES	ey l z
ALLIES	ae l ay z
ALLIES'	ae l ay z
ALLING	ao l ih ng
ALLMON	ao l m ah n
ALLNET	ao l n eh t
ALLPHIN	ah l f ih n
ALLS	ao l z
ALLSOP	ao l s aa p
ALLTIME	ao l t ay m
ALLUMS	ae l ah m z
ALMAL	aa l m ah l
ALMO	aa l m ow
ALMONTE	aa l m ow n t ey
ALOISIA	aa l oy s iy ah
ALONE	ah l ow n
ALONZO	ah l aa n z ow
ALPERIN	ae l p er ih n
ALPO	ae l p ow
ALROY	ah l r oy
ALSBURY	ao l z b eh r iy
ALSTON	ao l s t ah n
ALTER	ao l t er
ALTO	ae l t ow
ALTOM	ah l t aa m
ALTOONA	ae l t uw n ah
ALUMINA	ah l uw m ah n ah
ALUMNA	ah l ah m n ah
ALUN	ey l ah n
ALVEAR	aa l v ih r
ALVERO	ae l v eh r ow
ALWAYS	ao l w ey z
ALYSSA	ah l ih s ah
ALZA	ae l z ah
ALZENA	aa l z eh n ah
AMABEL	ae m ah b eh l
AMALYA	ah m aa l y ah
AMANDAS	ah m ae n d ah z
AMANTE	aa m aa n t iy
AMARO	aa m aa r ow
AMASSES	ah m ae s ih z
AMBERG	ae m b er g
AMDUR	ae m d er
AMEDCO	ah m eh d k ow
AMERIGO	aa m er iy g ow
AMES	ey m z
AMHERST	ae m er s t
AMIABLY	ey m iy ah b l iy
AMICONE	ae m ih k ow n
AMIDST	ah m ih d s t
AMIN	aa m iy n
AMIRAN	ae m ih r ah n
AMIRAV	ae m ih r ae v
AMMANN	ae m ah n
AMNIO	ae m n iy ow
AMOCO	ae m ah k ow
AMORY	ey m er iy
AMP	ae m p
AMPHORA	ae m f er ah
AMR	aa m er
AMRO	ae m r ow
AMSTAR	ae m s t aa r
AMY	ey m iy
ANACIN	ae n ah s ih n
ANACKER	ae n ah k er
ANAGRAM	ae n ah g r ae m
ANAHEIM	ae n ah hh ay m
ANALYZE	ae n ah l ay z
ANAST	aa n aa s t
ANASTAS	ae n ah s t ah z
ANATOLA	aa n aa t ow l ah
ANDERA	ae n d er ah
ANDINO	aa n d iy n ow
ANDLER	ae n d l er
ANDORRA	ae n d ao r ah
ANDOVER	ae n d ow v er
ANDRAE	aa n d r ay
ANDRAKI	ae n d ae k iy
ANDRE	aa n d r ey
ANE	ey n
ANEMONE	ae n ih m ow n
ANGELO	ae n jh ah l ow
ANGELS'	ey n jh ah l z
ANGI	ae n jh iy
ANGOVE	aa ng g ow v iy
ANINAT	ae n ih n ae t
ANKLET	ae ng k l ih t
ANN	ae n
ANNEAL	ah n iy l
ANNIE'S	ae n iy z
ANNOY	ah n oy
ANOTHER	ah n ah dh er
ANSCHEL	ae n sh ah l
ANSE	ae n s
ANSELM	ae n s eh l m
ANSELMI	aa n s eh l m iy
ANSHAN	ae n sh ah n
ANSON	ae n s ah n
ANSTISS	ae n s t ih s
ANTENNE	ae n t eh n
ANTHES	ae n dh ah z
ANTRIL	ae n t r ih l
ANTRIM	ae n t r ih m
ANYON	eh n iy aa n
ANZA	ae n z ah
AOKI	ey ow k iy
AON	ey ow n
APATITE	ae p ah t ay t
APES	ey p s
APHIDS	ae f ih d z
APOSTOL	ae p ah s t ah l
APPERT	ae p er t
APPIA	ae p iy ah
APPLAUD	ah p l ao d
APPRISE	ah p r ay z
APRILE	aa p r ah l
APSTAR	ae p s t aa r
ARABS'	ae r ah b z
ARAKAWA	aa r aa k aa w ah
ARAMCO	er ae m k ow
ARANA	aa r ae n ah
ARBED	aa r b ih d
ARBO	aa r b ow
ARCADE	aa r k ey d
ARCARO	aa r k aa r ow
ARCO	aa r k ow
ARDELIA	aa r d eh l iy ah
ARDENT	aa r d ah n t
ARDRA	aa r d r ah
ARE	aa r
AREN'T	aa r ah n t
ARENDT	eh r ih n t
AREVALO	aa r ey v aa l ow
ARGALL	aa r g ah l
ARGIRO	aa r jh ih r ow
ARGOT	aa r g ah t
ARGUED	aa r g y uw d
ARGUETA	aa r g ey t ah
ARIA	aa r iy ah
ARIAS'S	aa r iy ah s ih z
ARIS	er iy s
ARJO	aa r jh ow
ARKADI	aa r k ah d iy
ARKLA'S	aa r k l ah z
ARKOSE	aa r k ow s
ARLEDGE	aa r l ih jh
ARLEN	aa r l ah n
ARLT	aa r l t
ARMANI	aa r m aa n iy
ARMENTA	aa r m eh n t ah
ARMINIE	aa r m ih n iy
ARMTEK	aa r m t eh k
ARNOT	aa r n ah t
AROCHO	aa r ow k ow
AROMA	er ow m ah
ARON	eh r ah n
ARONE	er ow n
ARONOW	er ow n ow
ARRAY	er ey
ARRICK	ae r ih k
ARTEAGA	aa r t iy g ah
ARTHUR	aa r th er
ARTOIS	aa r t w aa
ARTRA	aa r t r ah
ARTRA'S	aa r t r ah z
ARTURO	aa r t uh r ow
ARTY'S	aa r t iy z
ARVAY	aa r v ey
ARVID	aa r v ih d
ARVIN'S	aa r v ih n z
ARZATE	aa r z ey t
ARZOLA	aa r z ow l ah
ASAMERA	ae s ah m eh r ah
ASBILL	ah s b ih l
ASCAP	ae s k ae p
ASCHE	ae sh
ASENCIO	ah s eh n s iy ow
ASHA	aa sh ah
ASHLIN	ae sh l ih n
ASININE	ae s ah n ay n
ASP	ae s p
ASSAF	ah s ae f
ASSAIL	ah s ey l
ASSANTE	aa s aa n t iy
ASSAYER	ae s ey er
ASSIST	ah s ih s t
ASSUAGE	ah s w ey jh
ASSUBEL	ae s ah b eh l
ASSUMES	ah s uw m z
ASSURAS	ah sh uh r ah s
ASSURES	ah sh uh r z
ASTER	ae s t er
ASTERS	ae s t er z
ASTLE	ae s ah l
ASTOR'S	ae s t er z
ASTRAL	ae s t r ah l
ASTRAY	ah s t r ey
ASTROS	ae s t r ow s
ATAXIA	ey t ae k s iy ah
ATCHLEY	ae ch l iy
ATEN	ey t ah n
ATHALIA	ey th ae l iy ah
ATHANAS	ey th ae n ah z
ATHEARN	ey th er n
ATHEIST	ey th iy ah s t
ATHENS	ae th ah n z
ATICO	ae t ih k ow
ATITHER	ah t ih dh er
ATKIN	ah t k ih n
ATLANTA	ae t l ae n t ah
ATOLL	ae t aa l
ATTICS	ae t ih k s
ATTIRED	ah t ay r d
ATTLEE	ae t l iy
ATTRACT	ah t r ae k t
ATWATER	ae t w ao t er
ATWOOD	ae t w uh d
ATYPIC	ey t ih p ih k
AUBIN	ao b ih n
AUCH	ao ch
AUCLAIR	ow k l eh r
AUCOIN	ow k oy n
AUDET	ow d eh t
AUDRIE	ao d er iy
AUGMENT	ao g m eh n t
AUNE	ao n
AUNT'S	ae n t s
AUSTRIA	ao s t r iy ah
AUTEN	aw t ah n
AUTHORS	ao th er z
AUTORAD	ao t ow r ae d
AUTOS	ao t ow z
AUTRY	ao t r iy
AVAIL	ah v ey l
AVANTI	ah v aa n t iy
AVARICE	ae v er ah s
AVE	aa v ey
AVENGED	ah v eh n jh d
AVENGER	ah v eh n jh er
AVENUE	ae v ah n uw
AVENUES	ae v ah n uw z
AVILA	ah v ih l ah
AVILES	aa v iy l eh s
AVILLA	ah v ih l ah
AVIV	aa v iy v
AVMARK	ae v m aa r k
AVNER	ae v n er
AVOCET	ae v ah s eh t
AVOW	ah v aw
AVTEX	ae v t eh k s
AWASH	ah w aa sh
AWAY	ah w ey
AXIS	ae k s ah s
AXLON	ae k s l aa n
AXSOM	ae k s ah m
AXTMAN	ae k s t m ah n
AYDT	ey t
AYLES	ey l z
AYR	ey r
AYYAD'S	ay aa d z
AZALIA	aa z aa l iy ah
AZZATO	ah z aa t ow
B.	b iy
BAACK	b aa k
BAAR	b aa r
BAARS	b aa r z
BABAR	b aa b aa r
BABBLED	b ae b ah l d
BABE	b ey b
BABIN	b ae b ih n
BABSON	b ae b s ah n
BACCHI	b ae k iy
BACHTEL	b ae k t ah l
BACKS	b ae k s
BADEAH	b ah d iy ah
BADEAU	b ah d ow
BADY	b ey d iy
BAG	b ae g
BAGEL	b ey g ah l
BAGELS	b ey g ah l z
BAGGY	b ae g iy
BAGLIO	b ae g l iy ow
BAHA'IS	b aa hh aa ih z
BAHAM	b aa ah m
BAHAMA	b ah hh aa m ah
BAHL	b aa l
BAHNSEN	b aa n s ah n
BAILE	b ey l
BAIN'S	b ey n z
BAIRNCO	b eh r n k ow
BAIT	b ey t
BAIZE	b ey z
BAJOREK	b ae jh er eh k
BAKE	b ey k
BALANCE	b ae l ah n s
BALBACH	b ae l b aa k
BALBI	b ae l b iy
BALDEV	b aa l d eh v
BALDING	b ao l d ih ng
BALFANZ	b aa l f aa n z
BALI	b aa l iy
BALKE	b ey l k
BALLADE	b ah l aa d
BALLARD	b ae l er d
BALLER	b ao l er
BALLETS	b ae l ey z
BALLMAN	b ao l m ah n
BALLON	b ae l ah n
BALOGH	b ae l ow
BALSER	b ey l s er
BALSLEY	b ae l s l iy
BALTICA	b ae l t ih k ah
BALZANO	b aa l z aa n ow
BALZER	b ey l z er
BAMBACH	b ae m b aa k
BAMBERG	b ae m b er g
BAMFORD	b ae m f er d
BANANA	b ah n ae n ah
BANC	b ae ng k
BANCO	b ae ng k ow
BANDA	b ae n d ah
BANDS	b ae n d z
BANGED	b ae ng d
BANGKOK	b ae ng k aa k
BANKERT	b ae ng k er t
BANKING	b ae ng k ih ng
BANKS'S	b ae ng k s ih z
BANOUN	b ah n uw n
BANSAL	b aa n s aa l
BAR'S	b aa r z
BARABAR	b eh r ah b aa r
BARASCH	b ae r ah sh
BARCELO	b aa r ch eh l ow
BARCOMB	b aa r k ah m
BARI'S	b aa r iy z
BARING	b eh r ih ng
BARKAN	b aa r k ah n
BARKOW	b aa r k ow
BARLOW	b aa r l ow
BARNER	b aa r n er
BARNEYS	b aa r n iy z
BARNS	b aa r n z
BARR	b aa r
BARRA	b aa r ah
BARRECA	b aa r eh k ah
BARREL	b ae r ah l
BARRET	b ae r ih t
BARRISH	b ae r ih sh
BARROWS	b ae r ow z
BARSTAD	b aa r s t ah d
BART'S	b aa r t s
BARTEE	b aa r t iy
BARTEL	b aa r t ah l
BARTELL	b aa r t ey l
BARTHEL	b aa r th ah l
BARTHES	b aa r th s
BARTLEY	b aa r t l iy
BARTOW	b aa r t ow
BASA	b aa s ah
BASAYEV	b ae s aa y eh v
BASENJI	b ah s eh n jh iy
BASHAM	b ae sh ah m
BASHIR	b ah sh ih r
BASILE	b aa s ah l
BASKET	b ae s k ah t
BASKETT	b ae s k ih t
BASRA	b aa s r aa
BASSIST	b ey s ih s t
BASSLER	b ae s l er
BASSOON	b ah s uw n
BASTING	b ey s t ih ng
BASTION	b ae s ch ah n
BASTON	b ae s t ah n
BASTOW	b ae s t ow
BATAN	b ey t ah n
BATBOY	b ae t b oy
BATBOYS	b ae t b oy z
BATHER	b ey dh er
BATTERS	b ae t er z
BATTING	b ae t ih ng
BATTLED	b ae t ah l d
BATY	b ey t iy
BAUCUS	b aa k ah s
BAUGH	b ao
BAUMER	b aw m er
BAUXITE	b ao k s ay t
BAVER	b ey v er
BAWER	b ao er
BAXA	b ae k s ah
BAXT	b ae k s t
BAY'S	b ey z
BAYED	b ey d
BAYH	b ey
BAYING	b ey ih ng
BAYLIS	b ey l ih s
BAYLON	b ey l aa n
BAYNES	b ey n z
BAYSIDE	b ey s ay d
BAYUS	b ey ah s
BEACH'S	b iy ch ah z
BEACHUM	b iy ch ah m
BEAGEN	b iy g ah n
BEARDED	b ih r d ah d
BEARMAN	b eh r m ah n
BEASTON	b iy s t ah n
BEASTS	b iy s t s
BEATA	b iy ae t ah
BEATEN	b iy t ah n
BEATLE	b iy t ah l
BEATON	b iy t ah n
BEAULAC	b ow l ae k
BEAUX	b ow
BEAVAN	b eh v ah n
BEAVIS	b iy v ah s
BEAZLEY	b iy z l iy
BEBEE	b eh b iy
BEBOP	b iy b aa p
BECALM	b ih k aa m
BECAUSE	b ih k ao z
BECK	b eh k
BECKIE	b eh k iy
BECO	b iy k ow
BED	b eh d
BEDBUGS	b eh d b ah g z
BEDDING	b eh d ih ng
BEDE	b iy d
BEDFORD	b eh d f er d
BEDOUIN	b eh d ow ah n
BEDTIME	b eh d t ay m
BEEDE	b iy d
BEEDLE	b iy d ah l
BEEF	b iy f
BEEKMAN	b iy k m ah n
BEENS	b ih n z
BEEPS	b iy p s
BEETLES	b iy t ah l z
BEETS	b iy t s
BEG	b eh g
BEGAN	b ih g ae n
BEGGED	b eh g d
BEHLER	b eh l er
BEHLING	b eh l ih ng
BEHYMER	b eh hh ay m er
BEIGEL	b ay g ah l
BEISSEL	b ay s ah l
BEIT	b ey t
BELEN	b eh l ah n
BELET	b eh l ah t
BELICH	b eh l ih k
BELIEF	b ih l iy f
BELIEFS	b ih l iy f s
BELIZE	b eh l iy z
BELLBOY	b eh l b oy
BELLES	b eh l z
BELLIES	b eh l iy z
BELONGS	b ih l ao ng z
BELOVE	b ih l ah v
BELY	b ah l ay
BEMAN	b iy m ah n
BEMOAN	b ih m ow n
BENAK	b eh n ah k
BENDA	b eh n d ah
BENDEL	b eh n d ah l
BENDT	b eh n t
BENEATH	b ih n iy th
BENECKE	b eh n ah k
BENEDEK	b eh n ah d ih k
BENES	b eh n iy s
BENESCH	b eh n ah sh
BENET'S	b eh n ah t s
BENGAL	b eh ng g ah l
BENGUET	b eh ng g ah t
BENIGHT	b iy n ay t
BENIGN	b ih n ay n
BENNE	b eh n
BENNEY	b eh n iy
BENNIS	b eh n ih s
BENONI	b eh n ow n iy
BERAN	b eh r ah n
BEREFT	b er eh f t
BERG'S	b er g z
BERGES	b er jh ih z
BERGREN	b er g r eh n
BERKMAN	b er k m ah n
BERLIOZ	b er l iy ow z
BERMAN	b er m ah n
BERMANS	b er m ah n z
BERMEA	b eh r m iy ah
BERMEL	b er m ah l
BERNAT	b er n ah t
BERNEY	b er n iy
BERNIER	b er n iy er
BERNSEN	b er n s ah n
BERNT	b er n t
BERNY	b er n iy
BERSHAD	b er sh aa d
BERT	b er t
BERTELS	b er t ah l z
BERTH	b er th
BERTSCH	b er ch
BES	b iy z
BESSEY	b eh s iy
BESSO	b eh s ow
BESTIAL	b eh s ch ah l
BETAMAX	b ey t ah m ae k s
BETHEL	b eh th ah l
BETRAY	b ih t r ey
BETRAYS	b ih t r ey z
BETS	b eh t s
BETSEY	b eh t s iy
BETTINI	b eh t iy n iy
BETTINO	b eh t iy n ow
BETTMAN	b eh t m ah n
BETZ	b eh t s
BEUTEL	b y uw t eh l
BEVARD	b ih v aa r d
BEVIS	b eh v ih s
BEY	b ey
BHUTTO	b uw t ow
BIAS	b ay ah s
BIBBINS	b ih b ih n z
BIBLE'S	b ay b ah l z
BIC	b ih k
BICYCLE	b ay s ih k ah l
BID	b ih d
BIDDEN	b ih d ih n
BIDDER	b ih d er
BIENIEK	b ih n iy eh k
BIERNAT	b ih r n ae t
BIES	b ay z
BIEV'S	b iy v z
BIGELOW	b ih g ah l ow
BIGFORD	b ih g f er d
BIGHORN	b ih g hh ao r n
BIGHT	b ay t
BIGOTED	b ih g ah t ih d
BIGOTRY	b ih g ah t r iy
BIGRAM	b ay g r ae m
BIHM	b ih m
BIKO	b iy k ow
BILBO	b ih l b ow
BILBREY	b ih l b r iy
BILLIAD	b ih l iy ah d
BILLOWS	b ih l ow z
BILOTTA	b ih l ow t ah
BILSKI	b ih l s k iy
BINDING	b ay n d ih ng
BINDLE	b ih n d ah l
BINETTE	b ih n eh t
BINGMAN	b ih ng m ah n
BINNIE	b ih n iy
BINZ	b ih n z
BIOCINE	b ay ah s iy n
BIOMES	b ay ow m z
BIOSYS	b ay ow s ih s
BIOTITE	b ay ah t ay t
BIPLANE	b ay p l ey n
BIR	b er
BIRDDOG	b er d d aw g
BIRGE	b er jh
BIRK	b er k
BIRKEY	b er k iy
BIRO	b ih r ow
BIRREN	b er ah n
BISESI	b ih s eh s iy
BISH	b ih sh
BISHOP	b ih sh ah p
BITCH	b ih ch
BITE	b ay t
BITHER	b ih dh er
BITTERS	b ih t er z
BITTMAN	b ih t m ah n
BIVALVE	b ay v ae l v
BIVEN	b ay v ah n
BIVENS	b ay v ah n z
BIZ	b ih z
BLADED	b l ey d ih d
BLAGDEN	b l ae g d ah n
BLAKER	b l ey k er
BLAMES	b l ey m z
BLASIER	b l ey z iy er
BLATZ	b l ae t s
BLAYDES	b l ey d z
BLAYZE	b l ey z
BLECHER	b l eh k er
BLEED	b l iy d
BLEIER	b l ay er
BLEMISH	b l eh m ih sh
BLETHEN	b l eh th ah n
BLIXT	b l ih k s t
BLOB	b l aa b
BLOC'S	b l aa k s
BLOCH'S	b l aa k s
BLOK	b l aa k
BLOKE	b l ow k
BLONDES	b l aa n d z
BLOODED	b l ah d ih d
BLOOR	b l uh r
BLOUGH	b l aw
BLOWN	b l ow n
BLOWY	b l ow iy
BLOXOM	b l aa k s ah m
BLUFFER	b l ah f er
BLUITT	b l uw t
BLUNDER	b l ah n d er
BLUNTER	b l ah n t er
BLUNTLY	b l ah n t l iy
BLURB	b l er b
BO-SHEK	b ow sh eh k
BOARDED	b ao r d ah d
BOAT	b ow t
BOATMAN	b ow t m ah n
BOBBIE	b aa b iy
BOBBING	b aa b ih ng
BOBECK	b ow b eh k
BOBOLAS	b ow b ow l ah s
BOCCE	b ow ch iy
BOCOOK	b aa k uh k
BOCUSE	b ow k y uw z
BODANIS	b ow d aa n ih s
BODELL	b ah d eh l
BOE	b ow
BOEGER	b ow g er
BOEHL	b ow l
BOEHLE	b ow hh ah l
BOEHMER	b ow m er
BOEHNER	b ow n er
BOEHNKE	b ow ng k
BOEKER	b ow k er
BOENIG	b ow n ih g
BOER	b ao r
BOESAK	b ow z ae k
BOFORS	b ow f er z
BOGACZ	b aa g ah ch
BOGGLES	b aa g ah l z
BOGUE	b ow g
BOHART	b aa hh aa r t
BOHEN	b ow ah n
BOHLMAN	b ow l m ah n
BOHN	b ow n
BOIKE	b oy k
BOIL	b oy l
BOILERS	b oy l er z
BOLAN	b ow l ah n
BOLDING	b ow l d ih ng
BOLDON	b ow l d ah n
BOLIDEN	b ow l ih d ah n
BOLKOW	b ow l k aw
BOLLEN	b aa l ah n
BOLLER	b aa l er
BOLLING	b ow l ih ng
BOLOTIN	b aa l ah t ih n
BOLSTER	b ow l s t er
BOLTED	b ow l t ah d
BOLTS	b ow l t s
BOMBA	b aa m b ah
BOMBAST	b aa m b ae s t
BOMBER	b aa m er
BONAR	b ow n er
BONDS'	b aa n d z
BONG	b aa ng
BONGERS	b ao ng er z
BONIOR	b ow n iy er
BONKERS	b aa ng k er z
BONTA	b aa n t ah
BONURA	b ow n uh r ah
BONUSES	b ow n ah s ih z
BONWELL	b aa n w eh l
BOOGIE	b uw g iy
BOOK'S	b uh k s
BOOR	b uh r
BOORMAN	b uh r m ah n
BOORS	b uh r z
BOOTE	b uw t
BOOZER	b uw z er
BOPP	b aa p
BORAK	b ao r ah k
BORDAS	b ao r d ah z
BORDEAU	b er d ow
BORDES	b ao r d z
BORN	b ao r n
BORNER	b ao r n er
BOROFF	b ao r ao f
BOROIAN	b ao r oy ah n
BORRELL	b ao r ey l
BORRIS	b ao r ih s
BORTON	b ao r t ah n
BOSEMAN	b ow s m ah n
BOSSMAN	b ao s m ah n
BOTANIC	b ah t ae n ih k
BOTELHO	b ow t eh l ow
BOTHE	b ow dh
BOTOX	b ow t ao k s
BOTTEN	b aa t ah n
BOTTGER	b aa t g er
BOTTLER	b aa t l er
BOUCHIE	b aw ch iy
BOUGHT	b aa t
BOUIE	b uw iy
BOUMA	b ow m ah
BOUNTY	b aw n t iy
BOUR	b aw r
BOUTON	b aw t ah n
BOUTROS	b uw t r ow s
BOUWENS	b aw ah n z
BOWATER	b aw ah t er
BOWEL	b aw ah l
BOWELL	b aa w eh l
BOWER	b aw er
BOWERY	b aw er iy
BOWL	b ow l
BOWLERS	b ow l er z
BOWLEY	b ow l iy
BOWNE	b ow n
BOWRON	b ow r ah n
BOXCAR	b aa k s k aa r
BOYAR	b ow y aa r
BOYERS	b oy er z
BOYES	b oy z
BOYKINS	b oy k ih n z
BOYLAND	b oy l ah n d
BOYS	b oy z
BOZARTH	b aa z er th
BOZELL	b ow z eh l
BOZIAN	b ow z iy ah n
BRA	b r aa
BRACCO	b r ae k ow
BRACHT	b r ae k t
BRACKIN	b r ae k ih n
BRADLEE	b r ae d l iy
BRADT	b r ae d t
BRADTKE	b r ae d k iy
BRAGGER	b r ae g er
BRAHMS	b r aa m z
BRAIN'S	b r ey n z
BRAINS	b r ey n z
BRAISED	b r ey z d
BRAMBLE	b r ae m b ah l
BRAMEL	b r ae m ah l
BRAMLEY	b r ae m l iy
BRANDLE	b r ae n d ah l
BRANDS'	b r ae n d z
BRANIFF	b r ae n ih f
BRANK'S	b r ae ng k s
BRANNAN	b r ae n ah n
BRANNUM	b r ae n ah m
BRASEL	b r ae s ah l
BRATON	b r ae t ih n
BRATS	b r ae t s
BRAVERY	b r ey v er iy
BRAVING	b r ey v ih ng
BRAWL	b r ao l
BRAWLS	b r ao l z
BRAWNER	b r ao n er
BRAXTON	b r ae k s t ah n
BRAZEE	b r ae z iy
BRAZELL	b r ae z ah l
BRAZIL	b r ah z ih l
BRCKO'S	b er ch k ow z
BREBACH	b r eh b ah k
BREEDER	b r iy d er
BREGE	b r iy jh
BREHM	b r eh m
BREIT	b r iy t
BRENDEL	b r eh n d ah l
BRENT	b r eh n t
BREST	b r eh s t
BRETTON	b r eh t ah n
BREVITY	b r eh v ah t iy
BREW	b r uw
BRIBE	b r ay b
BRIC	b r ih k
BRICENO	b r iy ch eh n ow
BRIEANT	b r iy ah n t
BRILEY	b r ih l iy
BRISKER	b r ih s k er
BRISKI	b r ih s k iy
BRISON	b r ih s ah n
BRISSEY	b r ih s iy
BRISTLE	b r ih s ah l
BRITISH	b r ih t ih sh
BRITO	b r iy t ow
BRITT	b r ih t
BRITTAN	b r ih t ah n
BRODEUR	b r aa d er
BRODSKY	b r aa d s k iy
BROGAN	b r ow g ah n
BROGDEN	b r aa g d ah n
BROGNA	b r ow g n ah
BROIL	b r oy l
BROILED	b r oy l d
BROIN	b r oy n
BROLLY	b r aa l iy
BROMAN	b r ow m ah n
BRONZEN	b r aa n z ah n
BROOKER	b r uh k er
BROOKS'	b r uh k s
BROOM	b r uw m
BROSNAN	b r aa s n ah n
BROUSE	b r aw s
BROWED	b r aw d
BROWER	b r aw er
BROWS	b r aw z
BROYLES	b r oy l z
BROZ	b r aa z
BRUBECK	b r uw b eh k
BRUEGGE	b r uw g ah
BRUFORD	b r uw f er d
BRUGMAN	b r ah g m ah n
BRULE	b r uw l
BRUNCH	b r ah n ch
BRUNO'S	b r uw n ow z
BRUNTON	b r ah n t ah n
BRUSKE	b r ah s k
BRUTISH	b r uw t ih sh
BRYDGES	b r ih jh ih z
BUCHER	b ah k er
BUCHERT	b ah ch er t
BUCHMAN	b ah k m ah n
BUCHOLZ	b ah k ow l z
BUCHS	b ah k s
BUCHTER	b ah k t er
BUCK	b ah k
BUCKEY	b ah k iy
BUCKLES	b ah k ah l z
BUCKNER	b ah k n er
BUCKY	b ah k iy
BUDDE	b ah d
BUDDEN	b ah d ah n
BUDDY	b ah d iy
BUDDY'S	b ah d iy z
BUDGE	b ah jh
BUDGET	b ah jh ih t
BUDIN	b uw d ih n
BUDNICK	b ah d n ih k
BUDVAR	b ah d v aa r
BUDZ	b ah d z
BUE	b w eh
BUERRY	b eh r iy
BUFFALO	b ah f ah l ow
BUGGERS	b ah g er z
BUGGY	b ah g iy
BUGLE	b y uw g ah l
BUHRMAN	b uh r m ah n
BUICKS	b y uw ih k s
BUILDER	b ih l d er
BUILDUP	b ih l d ah p
BUKAR	b y uw k aa r
BULAT	b uw l ah t
BULEMIA	b ah l iy m iy ah
BULKLEY	b ah l k l iy
BULLIED	b uh l iy d
BULLION	b uh l y ah n
BULSON	b uh l s ah n
BULTEMA	b uw l t eh m ah
BULTMAN	b uh l t m ah n
BUM	b ah m
BUMMED	b ah m d
BUMPASS	b ah m p ae s
BUMPUS	b ah m p ah s
BUNDE	b ah n d
BUNDREN	b ah n d er ah n
BUNGE	b ah n jh
BUNGER	b ah ng er
BUNNIES	b ah n iy z
BUNZL	b ah n z ah l
BURAN	b y uw r ah n
BURDI	b uh r d iy
BURGAMY	b er g ah m iy
BURGHER	b er g er
BURHAM	b er hh ah m
BURKUS	b er k ah s
BURLEY	b er l iy
BURMA'S	b er m ah z
BURNELL	b er n ah l
BURNES	b er n z
BURNHAM	b er n ah m
BURNLEY	b er n l iy
BURNS'S	b er n z ih z
BUROW	b y uh r ow
BURR	b er
BURRIS	b er ih s
BURSE	b er s
BURSEY	b er s iy
BURSTON	b er s t ah n
BUSBEY	b ah s b iy
BUSCH'S	b uh sh ih z
BUSHAW	b uh sh ao
BUSHEY	b uh sh iy
BUSHMAN	b uh sh m ah n
BUSHY	b uh sh iy
BUSIED	b ih z iy d
BUSIER	b ih z iy er
BUSK	b ah s k
BUSSA	b uw s ah
BUSSE	b ah s
BUSSELL	b ah s ah l
BUTERA	b uw t eh r ah
BUTMAN	b ah t m ah n
BUTSCH	b ah ch
BUTTARS	b ah t er z
BUTTING	b ah t ih ng
BUTTON	b ah t ah n
BUTTRUM	b ah t r ah m
BUTTRY	b ah t r iy
BUY	b ay
BUYOUT	b ay aw t
BUZA	b y uw z ah
BYARD	b y aa r d
BYER	b ay er
BYERS'	b ay er z
BYGONE	b ay g ao n
BYLSMA	b ih l s m ah
BYRD	b er d
BYRLE	b ay r ah l
BYRNES	b er n z
C-SPAN	s iy s p ae n
C.O.D.	s iy ow d iy
C1	s iy w ah n
C5	s iy f ay v
CAB	k ae b
CABLE	k ey b ah l
CABOT	k ae b ah t
CABRINI	k ah b r iy n iy
CABS	k ae b z
CACAO	k ah k ey ow
CACHO	k ae ch ow
CACIQUE	k ah s iy k
CAD	k ae d
CADAVER	k ah d ae v er
CADE	k ey d
CADENCE	k ey d ah n s
CADETS	k ah d eh t s
CADIEUX	k ae d iy ow
CADLE	k ey d ah l
CAFFEE	k ae f iy
CAHNERS	k aa n er z
CAIL	k ey l
CAIRN	k eh r n
CAKED	k ey k t
CALCUTT	k ae l k ah t
CALGARY	k ae l g er iy
CALLARI	k aa l aa r iy
CALLAS	k ae l ah z
CALLED	k ao l d
CALLEJA	k aa l ey y ah
CALLERS	k ao l er z
CALLEY	k ae l iy
CALMEST	k aa m ah s t
CALTEX	k ah l t eh k s
CAMAROS	k ah m aa r ow s
CAMBRON	k ae m b r ah n
CAMELOT	k ae m ah l aa t
CAMELS	k ae m ah l z
CAMERAS	k ae m er ah z
CAMPANA	k aa m p ae n ah
CAMPO	k ae m p ow
CAMPS	k ae m p s
CAMPUS	k ae m p ah s
CAMUSO	k aa m uw s ow
CANADAY	k ae n ah d ey
CANEZ	k aa n eh z
CANINE	k ey n ay n
CANION	k ae n y ah n
CANKERS	k ae ng k er z
CANNAVO	k aa n aa v ow
CANNOT	k ae n aa t
CANON	k ae n ah n
CANRAD	k ae n r ae d
CANSECO	k ae n s eh k ow
CANSON	k ae n s ah n
CANTEY	k ae n t iy
CANTORS	k ae n t er z
CANTU	k ae n t uw
CAPECI	k ah p eh ch iy
CAPEK	k ae p ih k
CAPELLO	k ah p eh l ow
CAPITO	k aa p iy t ow
CAPPED	k ae p t
CAPRARO	k aa p r aa r ow
CAPTURE	k ae p ch er
CAPUANO	k aa p uw aa n ow
CARA'S	k eh r ah z
CARAHER	k ae r ah hh er
CARANO	k aa r aa n ow
CARAS	k aa r ah z
CARAWAY	k ae r ah w ey
CARCASS	k aa r k ah s
CARDS	k aa r d z
CARELLI	k aa r eh l iy
CARENA	k eh r iy n ah
CARFORA	k aa r f ao r ah
CARIDAD	k ae r ah d ae d
CARILLA	k aa r ih l ah
CARIN	k ae r ih n
CARLA'S	k aa r l ah z
CARLSEN	k aa r l s ah n
CARMACK	k aa r m ah k
CARMY	k aa r m iy
CARNES	k aa r n z
CAROSI	k er ow s iy
CARPING	k aa r p ih ng
CARPORT	k aa r p ao r t
CARRE	k aa r
CARREL	k ae r ah l
CARRIE	k eh r iy
CARRINO	k aa r iy n ow
CARSTEN	k aa r s t ah n
CARTEE	k aa r t iy
CARTON	k aa r t ah n
CARVES	k aa r v z
CARWELL	k aa r w eh l
CASASSA	k aa s aa s ah
CASCO	k ae s k ow
CASE	k ey s
CASEZE	k ah s iy z iy
CASHATT	k ae sh ah t
CASHES	k ae sh ih z
CASHMAN	k ae sh m ah n
CASINGS	k ey s ih ng z
CASSO	k ae s ow
CASTE	k ae s t
CASTOR	k ae s t er
CASUALS	k ae zh ah w ah l z
CATALDI	k aa t aa l d iy
CATELLI	k ah t eh l iy
CATES	k ey t s
CATON	k ae t ah n
CATS	k ae t s
CATT	k ae t
CAUSER	k ao z er
CAUSES	k aa z ah z
CAVALLO	k ah v ae l ow
CAVALRY	k ae v ah l r iy
CAVEAT	k ey v iy ae t
CAXTON	k ae k s t ah n
CAYMAN	k ey m ah n
CAYSON	k ey s ah n
CDC	s iy d iy s iy
CEARLEY	s er l iy
CEASE	s iy s
CECALA	ch eh k aa l ah
CECIL'S	s iy s ah l z
CEDE	s iy d
CEL	s eh l
CELENA	ch eh l eh n ah
CELERY	s eh l er iy
CELIA	s iy l y ah
CELIS	s eh l ih s
CELL	s eh l
CELLIO	ch eh l iy ow
CELLIST	ch eh l ah s t
CELLPRO	s eh l p r ow
CENSURE	s eh n sh er
CENTURI	s eh n t uh r iy
CEP	s eh p
CERNUDA	s er n uw d ah
CERRUTI	ch er uw t iy
CERSKA	k er s k ah
CERULLI	ch er uw l iy
CERUS	s eh r ah s
CESARZ	s ey s aa r z
CESIUM	s iy z iy ah m
CESTARO	ch eh s t aa r ow
CETUS	s iy t ah s
CETUS'S	s iy t ah s ih z
CHAFEE	ch ae f iy
CHAFFIN	ch ae f ih n
CHAIN	ch ey n
CHAIRES	sh eh r z
CHALK	ch aa k
CHALLIS	sh ae l iy
CHANDRA	ch ae n d r ah
CHANLEY	ch ae n l iy
CHANNEL	ch ae n ah l
CHAP	ch ae p
CHAPEL	ch ae p ah l
CHAPLAN	ch ae p l ah n
CHAPPIE	ch ae p iy
CHAR	ch aa r
CHARADE	sh er ey d
CHARD	ch aa r d
CHARTER	ch aa r t er
CHASE'S	ch ey s ih z
CHASTE	ch ey s t
CHATMON	ch ae t m ah n
CHATTIN	ch ae t ih n
CHAZZ	ch ae z
CHE'S	ch ey z
CHEAPEN	ch iy p ah n
CHEAPLY	ch iy p l iy
CHECKER	ch eh k er
CHECKS	ch eh k s
CHEER	ch ih r
CHEERS	ch ih r z
CHEIL	ch ay l
CHEKHOV	ch eh k aa v
CHELAN	ch eh l ah n
CHEMEL	k eh m eh l
CHERISH	ch eh r ih sh
CHERNEY	ch er n iy
CHERRY	ch eh r iy
CHESHER	ch eh sh er
CHESLER	ch eh s ah l er
CHESTON	ch eh s t ah n
CHEVIES	ch eh v iy z
CHEVIK	ch eh v ih k
CHEVY'S	ch eh v iy z
CHEYNEY	ch ey n iy
CHICKED	ch ih k t
CHIDED	ch ay d ih d
CHILDS	ch ay l d z
CHILE	ch ih l iy
CHILI	ch ih l iy
CHILIES	ch ih l iy z
CHILTON	ch ih l t ah n
CHIMP	ch ih m p
CHINK	ch ih ng k
CHIPPED	ch ih p t
CHIPPER	ch ih p er
CHIRPS	ch er p s
CHITA	ch iy t ah
CHITTER	ch ih t er
CHIYODA	ch ih y ow d ah
CHIZMAR	ch ih z m er
CHOKED	ch ow k t
CHONKO	ch aa ng k ow
CHOOSES	ch uw z ah z
CHOPIN	sh ow p ae n
CHOPPER	ch aa p er
CHORALE	k er ae l
CHOYCE	ch oy s
CHRISP	k r ih s p
CHRIST	k r ay s t
CHRISTO	k r ih s t ow
CHUCK'S	ch ah k s
CHUCKLE	ch ah k ah l
CHUDLER	ch ah d l er
CHUDZIK	ch ah d z ih k
CHUGOKU	ch uw g ow k uw
CHULA	ch uw l ah
CHUN	ch ah n
CHUNK	ch ah ng k
CHUNNEL	ch ah n ah l
CIAMPI	ch ao m p iy
CIANCI	ch ao n ch iy
CIARDI	ch er d iy
CICELY	s ih s ah l iy
CICHY	s ih ch iy
CIE	s iy
CIERA	s iy r ah
CIGAR	s ih g aa r
CIGARS	s ih g aa r z
CILLEY	s ih l iy
CIMA	ch iy m ah
CIMINI	ch iy m iy n iy
CIMO	ch iy m ow
CINDRIC	s ih n d r ih k
CINDY	s ih n d iy
CIOTTI	ch ow t iy
CIRCA	s er k ah
CIRCON	s er k aa n
CIRKIN	s er k ih n
CISKEI	s ih s k ey
CISZEK	ch ih sh eh k
CITADEL	s ih t ah d eh l
CITIES	s ih t iy z
CITIES'	s ih t iy z
CITRON	s ih t r ah n
CIULLO	ch uw l ow
CIVET	s ih v ah t
CIVIC	s ih v ih k
CLABIR	k l ae b ih r
CLAD	k l ae d
CLAMOR	k l ae m er
CLAN	k l ae n
CLANK	k l ae ng k
CLAR	k l aa r
CLARINE	k l eh r iy n
CLARO	k l aa r ow
CLASS	k l ae s
CLAUDIE	k l ao d iy
CLAUSE	k l ao z
CLAUSES	k l ao z ah z
CLAWED	k l ao d
CLAYTON	k l ey t ah n
CLEGG	k l eh g
CLEMEN	k l eh m ah n
CLERC	k l er k
CLERGY	k l er jh iy
CLEVE	k l iy v
CLEVIE	k l iy v iy
CLIFFS'	k l ih f s
CLIMAX	k l ay m ae k s
CLIMB	k l ay m
CLIMBS	k l ay m z
CLIMES	k l ay m z
CLIP	k l ih p
CLOCKER	k l aa k er
CLOER	k l ow er
CLOEY	k l ow iy
CLOGGED	k l ao g d
CLOGS	k l aa g z
CLOKE	k l ow k
CLONING	k l ow n ih ng
CLONTZ	k l aa n t s
CLOSEST	k l ow s ah s t
CLOSET	k l aa z ah t
CLOSEUP	k l ow s ah p
CLOTH	k l ao th
CLOTHS	k l ao th s
CLOUDED	k l aw d ih d
CLOUDY	k l aw d iy
CLOW	k l ow
CLOWN	k l aw n
CLUB	k l ah b
CLUNG	k l ah ng
CLYMENE	k l ih m iy n
CLYNE	k l ay n
CLYVE	k l ay v
CO-OP	k ow aa p
COACHED	k ow ch t
COARSE	k ao r s
COASTER	k ow s t er
COAXING	k ow k s ih ng
COAXUM	k ow k s ah m
COBURN	k ow b er n
COBY	k ow b iy
COCAINE	k ow k ey n
COCCARO	k ow k aa r ow
COCCHI	k ow k iy
COCKING	k aa k ih ng
COCKLE	k aa k ah l
COCKLES	k aa k ah l z
COCKS	k aa k s
COCUZZA	k ow k uw t s ah
CODAG	k ow d ae g
CODAY	k ow d ey
COEBURN	k ow b er n
COFFERS	k aa f er z
COFFIN	k ao f ih n
COFFINS	k ao f ih n z
COGENT	k ow jh ah n t
COGGINS	k aa g ih n z
COHERED	k ow hh ih r d
COHIBA	k ow hh iy b ah
COHOST	k ow hh ow s t
COINED	k oy n d
COLAN	k ow l ah n
COLBECK	k aa l b eh k
COLBY'S	k ow l b iy z
COLDS	k ow l d z
COLFORD	k ow l f er d
COLGIN	k ow l jh ih n
COLLATE	k ah l ey t
COLLAZO	k ow l aa z ow
COLLI	k ow l iy
COLLURA	k aa l uh r ah
COLLVER	k aa l v er
COLLY	k aa l iy
COLMAN	k ow l m ah n
COLOMA	k ow l ow m ah
COLOMBE	k ow l ow m b iy
COLTIE	k ow l t iy
COLUMBA	k ow l ah m b ah
COMBAT	k aa m b ae t
COMBING	k ow m ih ng
COMBY	k aa m b iy
COMEGYS	k aa m ih jh iy z
COMER	k ah m er
COMFORT	k ah m f er t
COMICAL	k aa m ih k ah l
COMLEY	k aa m l iy
COMMENT	k aa m eh n t
COMPACT	k aa m p ae k t
COMPO	k aa m p ow
COMPOSE	k ah m p ow z
COMSAT	k aa m s ae t
CONAIR	k aa n eh r
CONCHA	k aa n ch ah
CONCOCT	k ah n k aa k t
CONDER	k aa n d er
CONDIT	k aa n d ih t
CONDOR	k aa n d er
CONDREY	k aa n d r iy
CONFAIR	k aa n f eh r
CONFERS	k ah n f er z
CONFINE	k ah n f ay n
CONFORM	k ah n f ao r m
CONIC	k aa n ih k
CONKLIN	k aa ng k l ih n
CONLAN	k aa n l ah n
CONNON	k aa n ah n
CONNORS	k aa n er z
CONOCO	k aa n ah k ow
CONOVER	k aa n ah v er
CONRADY	k ah n r aa d iy
CONSIS	k aa n s ih s
CONSOLE	k aa n s ow l
CONTACT	k aa n t ae k t
CONTE	k ao n t
CONTEST	k aa n t eh s t
CONTINO	k aa n t iy n ow
CONTRAS	k aa n t r ah z
CONVAIR	k aa n v eh r
COOKERS	k uh k er z
COOKMAN	k uh k m ah n
COOKS	k uh k s
COOLING	k uw l ih ng
COOLLY	k uw l iy
COOMBE	k uw m b
COONES	k uw n z
COOS	k uw s
COPEN	k ow p ah n
COPIES	k aa p iy z
COPILOT	k ow p ay l ah t
COPLAN	k aa p l ah n
COPLEY	k aa p l iy
COPY	k aa p iy
CORBELL	k ao r b eh l
CORDAY	k ao r d ey
CORDIS	k ao r d ih s
CORDON	k ao r d ah n
CORDOVA	k ao r d ow v ah
CORELL	k ao r eh l
CORES	k ao r z
CORETTA	k ao r eh t ah
CORIA	k ao r iy ah
CORINNE	k er iy n
CORINTO	k ao r ih n t ow
CORLEW	k ao r l uw
CORMAN	k ao r m ah n
CORMANY	k ao r m ah n iy
CORMIER	k ao r m iy er
CORNEAS	k ao r n iy ah z
CORNELL	k ao r n eh l
CORNER	k ao r n er
CORNETT	k ao r n ih t
CORPORA	k ao r p er ah
CORPSE	k ao r p s
CORRODE	k er ow d
CORSE	k ao r s
CORTEGE	k ao r t eh zh
CORTINE	k ao r t iy n
COSBY	k ao z b iy
COSMA	k ow z m ah
COSMOS	k aa z m ow s
COSSACK	k ao s ah k
COSSEY	k aa s iy
COSTCO	k ao s t k ow
COSTEN	k ao s t ah n
COSTLOW	k ao s t l ow
COSTRA	k aa s t r ah
COSTS	k aa s t s
COTS	k aa t s
COTTMAN	k aa t m ah n
COTTO	k ow t ow
COTTON	k aa t ah n
COUDERT	k uw d er t
COULEE	k uw l iy
COULTAS	k uw l t aa z
COUPON	k uw p ao n
COUSER	k aw s er
COVEL	k ow v ah l
COVET	k ah v ah t
COWART	k aw aa r t
COWBOYS	k aw b oy z
COWIN	k aw ih n
COZINE	k ow z iy n iy
CRABBE	k r ae b
CRACKS	k r ae k s
CRAFTED	k r ae f t ih d
CRAFTS	k r ae f t s
CRAGGS	k r ae g z
CRAGO	k r aa g ow
CRAIN'S	k r ey n z
CRAINE	k r ey n
CRAMPON	k r ae m p ao n
CRANKED	k r ae ng k t
CRATON	k r ae t ah n
CRAVATH	k r ae v ah th
CRAVED	k r ey v d
CRAVEN	k r ey v ah n
CRAVIN	k r ey v ih n
CRAXI	k r ae k s iy
CREAK	k r iy k
CREAL	k r iy l
CREASON	k r iy s ah n
CREATES	k r iy ey t s
CRECHES	k r eh sh ah z
CREDLE	k r eh d ah l
CREEDS	k r iy d z
CREER	k r ih r
CREES	k r iy z
CREKO	k r eh k ow
CRESAP	k r eh s ah p
CRESPIN	k r eh s p ih n
CRESPO	k r eh s p ow
CRESSES	k r eh s ah z
CREW	k r uw
CREWEL	k r uw ah l
CRIDDLE	k r ih d ah l
CRIDER	k r ay d er
CRILLEY	k r ih l iy
CRIMEA	k r ay m iy ah
CRIMSON	k r ih m z ah n
CROCE	k r ow ch iy
CROFT	k r ao f t
CROGAN	k r ow g ah n
CROGHAN	k r aa g ah n
CRONCE	k r aa n s
CROOM	k r uw m
CROPPER	k r aa p er
CROSBIE	k r ao z b iy
CROSHAW	k r aa sh ao
CROTCH	k r aa ch
CROUNSE	k r aw n s
CROUP	k r uw p
CROWELL	k r ow ah l
CROWLE	k r aw l
CRUDE	k r uw d
CRUISER	k r uw z er
CRUSHES	k r ah sh ih z
CT	k ao r t
CUBA'S	k y uw b ah z
CUBBIES	k ah b iy z
CUBS'	k ah b z
CUCCIO	k uw ch iy ow
CUDD	k ah d
CUDDLE	k ah d ah l
CUDE	k y uw d
CUELLO	k uw eh l ow
CUFFED	k ah f t
CUFFEE	k ah f iy
CUING	k y uw ih ng
CUL	k ah l
CULHANE	k ah l hh ey n
CULPRIT	k ah l p r ih t
CULT	k ah l t
CULTURE	k ah l ch er
CUMMING	k ah m ih ng
CUNDILL	k ah n d ih l
CUNDY	k ah n d iy
CUOZZO	k w ow z ow
CUPOLA	k ah p ow l ah
CUPP	k ah p
CUPPETT	k ah p ih t
CURACAO	k y uh r ah s aw
CURATE	k y uh r ah t
CURB	k er b
CURCURU	k uh r k uh r uw
CURIALE	k uh r iy aa l iy
CURING	k y uh r ih ng
CURNUTT	k er n ah t
CURRERI	k uh r eh r iy
CURRIER	k er iy er
CURRO	k uh r ow
CURSING	k er s ih ng
CURVES	k er v z
CURVIN	k er v ih n
CUSHY	k uh sh iy
CUSK	k ah s k
CUSTER	k ah s t er
CUT	k ah t
CUTAWAY	k ah t ah w ey
CUTCHER	k ah ch er
CUTOFF	k ah t ao f
CUTOUT	k ah t aw t
CUTRELL	k ah t r ah l
CUTRONE	k uw t r ow n iy
CUTTER	k ah t er
CUTTINO	k uw t iy n ow
CXC	s iy eh k s s iy
CYB	s ay b
CYCLING	s ay k ah l ih ng
CYCOLOR	s ih k ah l er
CYMBAL	s ih m b ah l
CYPERT	s ay p er t
CYRIL	s ih r ah l
CZAJKA	ch ay k ah
CZECH	ch eh k
DA'S	d iy ey z
DABBING	d ae b ih ng
DACE	d ey s
DACUNHA	d ah k ah n hh ah
DADDY	d ae d iy
DADFAR	d ae d f aa r
DADO	d ey d ow
DAEMON	d iy m ah n
DAFFERN	d ae f er n
DAHNKE	d ae ng k
DAIICHI	d ay iy ch iy
DAIN	d ey n
DAISIES	d ey z iy z
DAKOTAN	d ah k ow t ah n
DALBEC	d ae l b ih k
DALFORT	d ao l f er t
DALI	d aa l iy
DALIS	d ae l ih s
DALL	d ao l
DALOIA	d aa l ow y ah
DALPIAZ	d aa l p iy aa z
DALTON	d ao l t ah n
DALZELL	d ae l z ah l
DAMBACH	d ae m b aa k
DAME	d ey m
DAMIANO	d aa m iy aa n ow
DAMICO	d aa m iy k ow
DAMITZ	d ae m ih t s
DAMMAM	d ae m ah m
DAMNING	d ae m ih ng
DAMONS	d ey m ah n z
DAMPER	d ae m p er
DAMROW	d ae m r ow
DANCERS	d ae n s er z
DANELLA	d ah n eh l ah
DANES	d ey n z
DANGEWS	d ey n jh uw z
DANGLE	d ae ng g ah l
DANGLER	d ae ng g ah l er
DANIA	d ey n y ah
DANICA	d ae n ih k ah
DANJUB	d ae n jh uw b
DANSER	d ae n s er
DANTON	d ae n t ah n
DARA	d ae r ah
DARDEN	d aa r d ah n
DARE	d eh r
DAREN	d ae r ih n
DARES	d eh r z
DARN	d aa r n
DARNALL	d aa r n ah l
DARNEL	d aa r n ah l
DAROSA	d aa r ow s ah
DARSY	d aa r s iy
DARTED	d aa r t ih d
DASBURG	d ae s b er g
DATEK	d ae t eh k
DATTILO	d aa t iy l ow
DATUM	d ae t ah m
DAULTON	d ao l t ah n
DAUSTER	d aw s t er
DAVALOS	d aa v aa l ow z
DAVE'S	d ey v z
DAVES	d ey v z
DAVIDOW	d ae v ih d ow
DAVIO'S	d ae v iy ow z
DAVIR	d ah v ih r
DAVIS'S	d ey v ah s ah z
DAVLIN	d ae v l ih n
DAVOX	d ae v aa k s
DAWNS	d ao n z
DAXOR	d ae k s er
DAYCARE	d ey k eh r
DAYLE	d ey l
DAYTON	d ey t ah n
DAYWALT	d ey w ah l t
DEALS	d iy l z
DEALY	d iy l iy
DEANA	d iy ae n ah
DEARY	d ih r iy
DEATHLY	d eh th l iy
DEATLEY	d iy t l iy
DEBATER	d ah b ey t er
DEBATES	d ah b ey t s
DEBO	d iy b ow
DEBONO	d ih b ow n ow
DEBOR	d eh b ao r
DECH	d eh k
DECHANT	d ey ch ah n t
DECHENE	d eh k iy n
DECHINE	d eh ch ih n
DECIDED	d ih s ay d ih d
DECKARD	d ih k aa r d
DECKED	d eh k t
DECLERK	d ah k l er k
DECOOK	d eh k uh k
DECORUM	d ih k ao r ah m
DECRIED	d ih k r ay d
DECRIES	d ih k r ay z
DECUIR	d eh k ih r
DEDE	d iy d
DEEB	d iy b
DEEDY	d iy d iy
DEEMS	d iy m z
DEEPAK	d iy p ae k
DEERE	d ih r
DEFIED	d ih f ay d
DEFLECT	d ih f l eh k t
DEFUND	d iy f ah n d
DEFUSE	d ih f y uw z
DEFY	d ih f ay
DEGAS	d ey g ah s
DEGLER	d eh g l er
DEHNER	d eh n er
DEHNERT	d eh n er t
DEIFIED	d iy ah f ay d
DEIFY	d iy ah f ay
DEIGNS	d ey n z
DEIS	d iy z
DEITIES	d iy ah t iy z
DEJONGH	d ah jh ao ng
DELAP	d eh l ah p
DELAUNE	d eh l ao n
DELAVAL	d eh l ah v ae l
DELAYED	d ih l ey d
DELBERT	d eh l b er t
DELETED	d ih l iy t ah d
DELI	d eh l iy
DELIAL	d ih l ay eh l
DELISI	d eh l iy s iy
DELMAR	d eh l m er
DELMORE	d eh l m ao r
DELOREY	d eh l er iy
DELORIS	d eh l er ih s
DELORS	d ah l ao r z
DELP	d eh l p
DELRE	d eh l r
DELTAK	d eh l t ae k
DELTONA	d eh l t ow n ah
DELUCA	d ih l uw k ah
DELUCCA	d eh l uw k ah
DELUISE	d eh l uw s iy
DELZER	d eh l z er
DEMAYO	d ey m ey ow
DEMEO	d iy m iy ow
DEMETRE	d eh m iy t er
DEMISCH	d ah m ih sh
DEMISE	d ih m ay z
DEMISH	d eh m ih sh
DEMLER	d eh m l er
DEMON	d iy m ah n
DEMOS	d eh m ow z
DEMOTE	d ih m ow t
DEMUS	d iy m ah s
DENARDO	d ih n aa r d ow
DENBOW	d eh n b ow
DENES	d iy n z
DENGUE	d eh n g
DENIKE	d eh n ih k
DENMAN	d eh n m ah n
DENN	d eh n
DENNE	d eh n
DENNEHY	d eh n ih hh iy
DENNEN	d eh n ah n
DENNIN	d eh n ih n
DENNING	d eh n ih ng
DENNY	d eh n iy
DENOMME	d eh n ah m
DENOTE	d ih n ow t
DENOYER	d eh n oy er
DENSEST	d eh n s ah s t
DENTING	d eh n t ih ng
DENTTON	d eh n t ah n
DEON	d iy aa n
DEPAOLO	d ih p aw l ow
DEPARTS	d ih p aa r t s
DEPLORE	d ih p l ao r
DEPPE	d eh p
DEPREE	d ih p r iy
DEPRESS	d ih p r eh s
DERAMUS	d eh r ah m ih s
DEREGT	d er eh k t
DERING	d ih r ih ng
DERISO	d ih r iy s ow
DERIVED	d er ay v d
DERMAN	d er m ah n
DEROOS	d ih r uw z
DEROSIA	d ih r ow s iy ah
DERRY	d eh r iy
DERSCH	d er sh
DERSHEM	d er sh ih m
DERVIN	d er v ih n
DERWARD	d er w er d
DESERT	d eh z er t
DESHAW	d eh sh ao
DESIRES	d ih z ay er z
DESKPRO	d eh s k p r ow
DESTIN	d eh s t ih n
DETACH	d ih t ae ch
DETECTS	d ih t eh k t s
DETERT	d eh t er t
DETORE	d ih t ao r iy
DETRICH	d eh t r ih k
DETROIT	d ih t r oy t
DETZEL	d eh t z ah l
DEUSS	d uw s
DEV	d eh v
DEVEAUX	d ih v ow
DEVELOP	d ih v eh l ah p
DEVENNY	d eh v ih n iy
DEVEROY	d eh v er oy
DEVINO	d ih v iy n ow
DEVITO	d ih v iy t ow
DEVOUR	d ih v aw er
DEWAARD	d uw aa r d
DEWINE	d ah w ay n
DEWITTE	d uw ih t
DEWOLFE	d uw uh l f
DEWY	d uw iy
DEXTRIN	d eh k s t r ih n
DEZEEUW	d ih z iy uw
DFW	d iy eh f d ah b ah l y uw
DHEIN	d ay n
DHOLE	d ow l
DIAGRAM	d ay ah g r ae m
DIAMONO	d ay ah m aa n ow
DIANTHE	d ay ae n dh iy
DIAPSID	d ay ae p s ih d
DIAS	d ay ah z
DIATOMS	d ay ah t aa m z
DIBBLE	d ih b ah l
DIBBLED	d ih b ah l d
DIBRELL	d ih b r ah l
DICARLO	d ih k aa r l ow
DICENSO	d ih s eh n s ow
DICKEY	d ih k iy
DICKY	d ih k iy
DIDDLEY	d ih d l iy
DIDN'T	d ih d ah n t
DIEBOLD	d ay b ow l d
DIEDE	d iy d
DIERCKS	d iy r k s
DIERKS	d iy r k s
DIERS	d iy er z
DIETER	d iy t er
DIEVLER	d iy v l er
DIFFID	d ih f ah d
DIFFUSE	d ih f y uw s
DIFM	d ih f m
DIGGING	d ih g ih ng
DIGS	d ih g z
DIJKER	d iy k er
DILATE	d ay l ey t
DILLION	d ih l y ah n
DILUZIO	d ih l uw z iy ow
DIM	d ih m
DIME	d ay m
DIMOCK	d ih m ah k
DINARS	d ay n er z
DINESH	d ih n eh sh
DINGHAM	d ih ng ah m
DINGLER	d ih ng g ah l er
DINKY	d ih ng k iy
DINOSEB	d ay n ow s eh b
DINSA	d ih n s ah
DIONNE	d iy aa n
DIPIERO	d ih p ih r ow
DIPIRRO	d ih p ih r ow
DIPPED	d ih p t
DIPPEL	d ih p ah l
DIPPOLD	d ih p ow l d
DIRECT	d er eh k t
DIRGE	d er jh
DIROSA	d ih r ow s ah
DISALVO	d ih s aa l v ow
DISBRO	d ih s b r ow
DISEASE	d ih z iy z
DISKS	d ih s k s
DISMAL	d ih z m ah l
DISMAYS	d ih s m ey z
DISMISS	d ih s m ih s
DISOWN	d ih s ow n
DISPEL	d ih s p eh l
DISPELL	d ih s p eh l
DIVAD	d ih v ae d
DIVERSE	d ay v er s
DIVERTS	d ay v er t s
DIVIDE	d ih v ay d
DIVIDER	d ih v ay d er
DIVINEY	d ih v ih n iy
DIVISON	d ih v ih zh ah n
DIVORCE	d ih v ao r s
DIXY	d ih k s iy
DNA	d iy eh n ey
DNASE	d iy eh n ey s
DO	d uw
DOANNA	d ow n ah
DOB	d aa b
DOBBIN	d aa b ih n
DOBESH	d aa b ih sh
DOBKIN	d aa b k ih n
DOBY	d ow b iy
DOCIE	d aa k iy
DOCK'S	d aa k s
DOCKED	d aa k t
DODD	d aa d
DODGE'S	d aa jh ih z
DODGING	d aa jh ih ng
DODI	d ow d iy
DOEPKE	d ow p k
DOERS	d uw er z
DOFF	d ao f
DOFFING	d ao f ih ng
DOGGIES	d ao g iy z
DOGGONE	d ao g ao n
DOKE	d ow k
DOKEY	d ow k iy
DOLAN	d ow l ah n
DOLAND	d uw l ah n d
DOLBOW	d ow l b ow
DOLIN	d ow l ih n
DOLLAN	d ow l ah n
DOLLOFF	d aa l ao f
DOLLS	d aa l z
DOLNEY	d ow l n iy
DOMAN	d uw m ah n
DOMIN	d ow m ih n
DOMINI	d aa m ih n iy
DON'T	d ow n t
DONAHO	d ow n aa hh ow
DONAIS	d ah n ey
DONAR	d aa n er
DONAWAY	d aa n ah w ey
DONEHOO	d ow n ey hh uw
DONEY	d aa n iy
DONGEN	d ao ng g ah n
DONILON	d aa n ah l aa n
DONKEYS	d aa ng k iy z
DONNAN	d aa n ah n
DONOHOE	d aa n ah hh ow
DONOR'S	d ow n er z
DONS	d aa n z
DONUT	d ow n ah t
DOODLE	d uw d ah l
DOOLEN	jh uw l ah n
DOONAN	d uw n ah n
DOORMAT	d ao r m ae t
DOPE	d ow p
DOPP	d aa p
DORAIS	d er ey
DORDIES	d ao r d iy z
DORETTE	d er eh t
DORETTI	d ao r eh t iy
DORFF	d ao r f
DORIA	d ao r iy ah
DORIAN	d ao r iy ah n
DORICE	d ao r ih s
DORINE	d ao r iy n iy
DOROUGH	d ao r aw
DORRIE	d ao r iy
DORSEY	d ao r s iy
DORSI	d ao r s iy
DORTON	d ao r t ah n
DOSAGE	d ow s ah jh
DOSAGES	d ow s ih jh ih z
DOSTIE	d aa s t iy
DOTS	d aa t s
DOTTED	d aa t ah d
DOUBTED	d aw t ih d
DOUDNA	d aw d n ah
DOUGENS	d aw g ah n z
DOUGHER	d ow er
DOUGLAS	d ah g l ah s
DOUKAS	d aw k ah z
DOUR	d aw er
DOWDELL	d aw d ah l
DOWLER	d aw l er
DOWSMAN	d aw z m ah n
DOYEN	d oy ih n
DOYLE'S	d oy l z
DRAB	d r ae b
DRAGONS	d r ae g ah n z
DRAHEIM	d r ae hh ay m
DRAHOS	d r ey hh ow z
DRAINS	d r ey n z
DRAM	d r ae m
DRAMS	d r ae m z
DRAY	d r ey
DRAYER	d r ey er
DREADED	d r eh d ih d
DREGS	d r eh g z
DREMAN	d r iy m ah n
DRENNAN	d r eh n ah n
DRESHER	d r eh sh er
DRESSED	d r eh s t
DRESSES	d r eh s ah z
DRIBS	d r ih b z
DRIEST	d r ay ah s t
DRING	d r ih ng
DRIVE'S	d r ay v z
DROBKOV	d r ao b k ao v
DROOPED	d r uw p t
DROPLET	d r aa p l ah t
DROPSY	d r aa p s iy
DROST	d r aa s t
DRUCIE	d r ah k iy
DRUELLA	d r uw eh l ah
DRUGGED	d r ah g d
DRUMM	d r ah m
DRUMMEY	d r ah m iy
DRYPERS	d r ay p er z
DSOUZA	d ah s uw z ah
DUBA	d uw b ah
DUBARRY	d uw b eh r iy
DUBIEL	d ah b iy l
DUBS	d ah b z
DUCHESS	d ah ch ah s
DUD	d ah d
DUDLEY	d ah d l iy
DUDZIAK	d ah jh iy ae k
DUEKER	d uw k er
DUELED	d uw ah l d
DUELS	d uw ah l z
DUENA	d uw eh n ah
DUERSON	d uh r s ah n
DUET	d uw eh t
DUFAULT	d ah f ow
DUFFETT	d ah f ih t
DUFFUS	d ah f ah s
DUG	d ah g
DUGOUTS	d ah g aw t s
DUKAKIS	d uw k aa k ih s
DUKE	d uw k
DULANY	d y uw l ao n iy
DULCEA	d ah l s iy ah
DULCINE	d ah l s ih n
DULING	d y uw l ih ng
DULLER	d ah l er
DUM	d ah m
DUMKE	d ah m k iy
DUMLAO	d uw m l aw
DUMONT	d uw m aa n t
DUNGAN	d ah ng g ah n
DUNKLE	d ah ng k ah l
DUNKLEE	d ah ng k l iy
DUNLEVY	d uw n l ih v iy
DUNMAN	d ah n m ah n
DUNNELL	d ah n ah l
DUNSTAN	d ah n s t ah n
DUPIN	d ah p ae n
DUPUIS	d ah p w iy
DURANGO	d er ae ng g ow
DURAY	d uh r ey
DURAZO	d uh r aa z ow
DURBAN	d er b ah n
DURER	d uh r er
DURETTE	d er eh t
DURFEE	d er f iy
DURHAM	d er ah m
DURICK	d y uw r ih k
DURIE	d uh r iy
DURIO	d uh r iy ow
DURNEY	d er n iy
DUSSEAU	d ah s ow
DUSTER	d ah s t er
DUSTMAN	d ah s t m ah n
DUTCH	d ah ch
DUTIL	d ah t ih l
DUTTER	d ah t er
DUVREES	d uw v r iy z
DVORSKY	d v ao r s k iy
DWARFS	d w ao r f s
DWELT	d w eh l t
DWIRE	d w ay r
DYAN	d ay ae n
DYANA	d ay ae n ah
DYANE	d ay ae n
DYAS	d ay ah s
DYCHE	d ay ch
DYED	d ay d
DYLAN	d ih l ah n
DYLEX	d ay l ah k s
